ID ,Year,Release Group,Worldwide_gross,Inflation_rate,Worlwide_inflation,Domestic,Domestic_inflation,Foreign_gross,Foreign_inflation
2,2018,Avengers: Infinity War,2048359754,0.2439,2547954698,678815482,844378578.1,1369544272,1703576120
3,2018,Black Panther,1346913161,0.2439,1675425281,700059566,870804094.1,646853595,804621186.8
4,2018,Jurassic World: Fallen Kingdom,1308467944,0.2439,1627603276,417719760,519601609.5,890748184,1108001666
5,2018,Incredibles 2,1242805359,0.2439,1545925586,608581744,757014831.4,634223615,788910754.7
6,2018,Aquaman,1151961807,0.2439,1432925292,335061807,416783381.7,816900000,1016141910
7,2018,Bohemian Rhapsody,903655259,0.2439,1124056777,216428042,269214841.4,687227217,854841935.2
8,2018,Venom,856085151,0.2439,1064884319,213515506,265591937.9,642569645,799292381.4
9,2018,Mission: Impossible - Fallout,791115104,0.2439,984068077.9,220159104,273855909.5,570956000,710212168.4
10,2018,Deadpool 2,734546611,0.2439,913702529.4,318491426,396171484.8,416055185,517531044.6
11,2018,Fantastic Beasts: The Crimes of Grindelwald,655755901,0.2439,815694765.3,159555901,198471585.3,496200000,617223180
12,2018,Ant-Man and the Wasp,622674139,0.2439,774544361.5,216648740,269489367.7,406025399,505054993.8
13,2018,Ready Player One,583490172,0.2439,725803425,137690172,171272805,445800000,554530620
14,2018,Operation Red Sea,579330426,0.2439,720629116.9,1543547,1920018.113,577786879,718709098.8
15,2018,Detective Chinatown 2,544185156,0.2439,676911915.5,1983984,2467877.698,542201172,674444037.9
16,2018,Ralph Breaks the Internet,529323962,0.2439,658426076.3,201091711,250137979.3,328232251,408288097
17,2018,The Meg,529243742,0.2439,658326290.7,145443742,180917470.7,383800000,477408820
18,2018,Hotel Transylvania 3: Summer Vacation,528583774,0.2439,657505356.5,167510016,208365708.9,361073758,449139647.6
19,2018,The Grinch,512453517,0.2439,637440929.8,271478510,337692118.6,240975007,299748811.2
20,2018,Bumblebee,467989645,0.2439,582132319.4,127195589,158218593.2,340794056,423913726.3
21,2018,Dying to Survive,451176639,0.2439,561218621.3,0,0,451176639,561218621.3
22,2018,A Star Is Born,436388866,0.2439,542824110.4,215288866,267797820.4,221100000,275026290
23,2018,Rampage,428128233,0.2439,532548709,101028233,125669019,327100000,406879690
24,2018,Mamma Mia! Here We Go Again,395044706,0.2439,491396109.8,120634935,150057795.6,274409771,341338314.1
25,2018,Solo: A Star Wars Story,392924807,0.2439,488759167.4,213767512,265905408.2,179157295,222853759.3
26,2018,Spider-Man: Into the Spider-Verse,375582637,0.2439,467187242.2,190241310,236641165.5,185341327,230546076.7
27,2018,Fifty Shades Freed,371985018,0.2439,462712163.9,100407760,124897212.7,271577258,337814951.2
28,2018,Hello Mr. Billionaire,366961907,0.2439,456463916.1,0,0,366961907,456463916.1
29,2018,The Nun,366050119,0.2439,455329743,117450119,146096203,248600000,309233540
30,2018,Monster Hunt 2,361682618,0.2439,449897008.5,706153,878383.7167,360976465,449018624.8
31,2018,Peter Rabbit,351266433,0.2439,436940316,115253424,143363734.1,236013009,293576581.9
32,2018,Mary Poppins Returns,349537494,0.2439,434789688.8,171958438,213899101,177579056,220890587.8
33,2018,A Quiet Place,340939361,0.2439,424094471.1,188024361,233883502.6,152915000,190210968.5
34,2018,Green Book,321752656,0.2439,400228128.8,85080171,105831224.7,236672485,294396904.1
35,2018,Skyscraper,304868961,0.2439,379226500.6,68420120,85107787.27,236448841,294118713.3
36,2018,Ocean's Eight,297718711,0.2439,370332304.6,140218711,174418054.6,157500000,195914250
37,2018,Pacific Rim: Uprising,290930148,0.2439,361888011.1,59874525,74477921.65,231055623,287410089.4
38,2018,Maze Runner: The Death Cure,288175335,0.2439,358461299.2,58032443,72186555.85,230142892,286274743.4
39,2018,Tomb Raider,274950803,0.2439,342011303.9,58250803,72458173.85,216700000,269553130
40,2018,Halloween,255485178,0.2439,317798012.9,159342015,198205532.5,96143163,119592480.5
41,2018,Crazy Rich Asians,239032921,0.2439,297333050.4,174532921,217101500.4,64500000,80231550
42,2018,Smallfoot,217940103,0.2439,271095694.1,83240103,103542364.1,134700000,167553330
43,2018,Creed II,214215889,0.2439,266463144.3,115715889,143938994.3,98500000,122524150
44,2018,Us and Them,209221380,0.2439,260250474.6,0,0,209221380,260250474.6
45,2018,The Island,198326350,0.2439,246698146.8,670883,834511.3637,197655467,245863635.4
46,2018,Christopher Robin,197744377,0.2439,245974230.6,99215042,123413590.7,98529335,122560639.8
47,2018,The Equalizer 2,190400157,0.2439,236838755.3,102084362,126982737.9,88315795,109856017.4
48,2018,Project Gutenberg,188116796,0.2439,233998482.5,0,0,188116796,233998482.5
49,2018,The Mule,174804407,0.2439,217439201.9,103804407,129122301.9,71000000,88316900
50,2018,The Nutcracker and the Four Realms,173961069,0.2439,216390173.7,54858851,68238924.76,119102218,148151249
51,2018,Insidious: The Last Key,167885588,0.2439,208832882.9,67745330,84268415.99,100140258,124564466.9
52,2018,The Predator,160542134,0.2439,199698360.5,51024708,63469634.28,109517426,136228726.2
53,2018,Johnny English Strikes Again,158970776,0.2439,197743748.3,4412170,5488298.263,154558606,192255450
54,2018,Red Sparrow,151572634,0.2439,188541199.4,46874505,58307196.77,104698129,130234002.7
55,2018,More Than Blue,142958164,0.2439,177825660.2,722669,898927.9691,142235495,176926732.2
56,2018,The First Purge,137056262,0.2439,170484284.3,69488745,86437049.91,67567517,84047234.4
57,2018,How Long Will I Love U,136796719,0.2439,170161438.8,746933,929109.9587,136049786,169232328.8
58,2018,A Wrinkle in Time,132675864,0.2439,165035507.2,100478608,124985340.5,32197256,40050166.74
59,2018,The House with a Clock in Its Walls,131457147,0.2439,163519545.2,68549695,85268965.61,62907452,78250579.54
60,2018,Instant Family,120556201,0.2439,149959858.4,67363237,83793130.5,53192964,66166727.92
61,2018,A Cool Fish,118153135,0.2439,146970684.6,551876,686478.5564,117601259,146284206.1
62,2018,Game Night,117679066,0.2439,146380990.2,69179066,86051840.2,48500000,60329150
63,2018,Dragon Ball Super: Broly,115750445,0.2439,143981978.5,30712119,38202804.82,85038326,105779173.7
64,2018,The Monkey King 3,115084576,0.2439,143153704.1,187074,232701.3486,114897502,142921002.7
65,2018,First Man,105697415,0.2439,131477014.5,44936545,55896568.33,60760870,75580446.19
66,2018,Book Club,104438188,0.2439,129910662.1,68566296,85289615.59,35871892,44621046.46
67,2018,Night School,103105878,0.2439,128253401.6,77339130,96202143.81,25766748,32051257.84
68,2018,Detective Conan: Zero the Enforcer,101860359,0.2439,126704100.6,0,0,101860359,126704100.6
69,2018,Alpha,99630675,0.2439,123930596.6,35857181,44602747.45,63773494,79327849.19
70,2018,Along With the Gods: The Last 49 Days,97962238,0.2439,121855227.8,1200246,1492985.999,96761992,120362241.8
71,2018,A Simple Favor,97644617,0.2439,121460139.1,53548586,66609086.13,44096031,54851052.96
72,2018,Boonie Bears: The Big Shrink,96845907,0.2439,120466623.7,0,0,96845907,120466623.7
73,2018,The Favourite,95918706,0.2439,119313278.4,34366783,42748841.37,61551923,76564437.02
74,2018,Truth or Dare,95330493,0.2439,118581600.2,41411015,51511161.56,53919478,67070438.68
75,2018,Kill Mobile,94870905,0.2439,118009918.7,0,0,94870905,118009918.7
76,2018,I Feel Pretty,94539426,0.2439,117597592,48795601,60696848.08,45743825,56900743.92
77,2018,Blockers,94017294,0.2439,116948112,60311495,75021468.63,33705799,41926643.38
78,2018,BlacKkKlansman,93400823,0.2439,116181283.7,49275340,61293595.43,44125483,54887688.3
79,2018,Goosebumps 2: Haunted Halloween,93320380,0.2439,116081220.7,46700633,58090917.39,46619747,57990303.29
80,2018,Shadow,91708374,0.2439,114076046.4,521396,648564.4844,91186978,113427481.9
81,2018,Overboard,91244913,0.2439,113499547.3,50316123,62588225.4,40928790,50911321.88
82,2018,Sherlock Gnomes,90497778,0.2439,112570186.1,43242871,53789807.24,47254907,58780378.82
83,2018,Detective Dee: The Four Heavenly Kings,90040771,0.2439,112001715,262963,327099.6757,89777808,111674615.4
84,2018,"Hello, Mrs. Money",86874070,0.2439,108062655.7,0,0,86874070,108062655.7
85,2018,Robin Hood,86489031,0.2439,107583705.7,30824628,38342754.77,55664403,69240950.89
86,2018,I Can Only Imagine,86086881,0.2439,107083471.3,83482352,103843697.7,2604529,3239773.623
87,2018,Hidden Man,85170581,0.2439,105943685.7,0,0,85170581,105943685.7
88,2018,Mortal Engines,83672673,0.2439,104080437.9,15951040,19841498.66,67721633,84238939.29
89,2018,iPartment the Movie,81096321,0.2439,100875713.7,0,0,81096321,100875713.7
90,2018,Doraemon the Movie: Nobita's Treasure Island,80920916,0.2439,100657527.4,0,0,80920916,100657527.4
91,2018,Den of Thieves,80509622,0.2439,100145918.8,44947622,55910347.01,35562000,44235571.8
92,2018,Hereditary,80080156,0.2439,99611706.05,44069456,54817996.32,36010700,44793709.73
93,2018,Code Blue: The Movie,78778562,0.2439,97992653.27,0,0,78778562,97992653.27
94,2018,Tag,78230625,0.2439,97311074.44,54730625,68079424.44,23500000,29231650
95,2018,Sanju,76693052,0.2439,95398487.38,7909317,9838399.416,68783735,85560087.97
96,2018,Vice,76073488,0.2439,94627811.72,47836282,59503551.18,28237206,35124260.54
97,2018,Widows,75984700,0.2439,94517368.33,42402632,52744633.94,33582068,41772734.39
98,2018,Sicario: Day of the Soldado,75837743,0.2439,94334568.52,50072235,62284853.12,25765508,32049715.4
99,2018,Searching,75462037,0.2439,93867227.82,26020957,32367468.41,49441080,61499759.41
100,2018,The Spy Who Dumped Me,75320680,0.2439,93691393.85,33562069,41747857.63,41758611,51943536.22
101,2018,Animal World,74922830,0.2439,93196508.24,0,0,74922830,93196508.24
102,2018,Amazing China,72506343,0.2439,90190640.06,0,0,72506343,90190640.06
103,2018,Second Act,72282227,0.2439,89911862.17,39282227,48863162.17,33000000,41048700
104,2018,Spirited Away 2018 Re-release,70186029,0.2439,87304401.47,1175067,1461665.841,69010962,85842735.63
105,2018,Shoplifters,67999335,0.2439,84584372.81,3313513,4121678.821,64685822,80462693.99
106,2018,12 Strong,67359190,0.2439,83788096.44,45819713,56995141,21539477,26792955.44
107,2018,"Love, Simon",66316289,0.2439,82490831.89,40826341,50783885.57,25489948,31706946.32
108,2018,Mile 22,66308758,0.2439,82481464.08,36108758,44915684.08,30200000,37565780
109,2018,Life of the Party,65659911,0.2439,81674363.29,53059911,66001223.29,12600000,15673140
110,2018,L Storm,64517456,0.2439,80253263.52,0,0,64517456,80253263.52
111,2018,Capernaum,64417003,0.2439,80128310.03,1661096,2066237.314,62755907,78062072.72
112,2018,Isle of Dogs,64241499,0.2439,79910000.61,32015231,39823745.84,32226268,40086254.77
113,2018,Andhadhun,62475342,0.2439,77713077.91,1193046,1484029.919,61282296,76229047.99
114,2018,Adrift,59945012,0.2439,74565600.43,31445012,39114450.43,28500000,35451150
115,2018,The 15:17 to Paris,57176286,0.2439,71121582.16,36276286,45124072.16,20900000,25997510
116,2018,A or B,56239049,0.2439,69955753.05,0,0,56239049,69955753.05
117,2018,Go Brother!,54663060,0.2439,67995380.33,0,0,54663060,67995380.33
118,2018,Early Man,54622814,0.2439,67945318.33,8267544,10283997.98,46355270,57661320.35
119,2018,Peppermint,53918723,0.2439,67069499.54,35418723,44057349.54,18500000,23012150
120,2018,Teen Titans GO! To the Movies,52390236,0.2439,65168214.56,29790236,37056074.56,22600000,28112140
121,2018,Slender Man,51738549,0.2439,64357581.1,30569484,38025381.15,21169065,26332199.95
122,2018,Breaking In,51411620,0.2439,63950914.12,46840590,58265009.9,4571030,5685904.217
123,2018,Cry Me a Sad River,51400614,0.2439,63937223.75,0,0,51400614,63937223.75
124,2018,Once Upon a Deadpool 2018 Re-release,51349833,0.2439,63874057.27,6100309,7588174.365,45249524,56285882.9
125,2018,Simmba,51329025,0.2439,63848174.2,5102129,6346538.263,46226896,57501635.93
126,2018,Family is Family,49954866,0.2439,62138857.82,0,0,49954866,62138857.82
127,2018,Death Wish,49562710,0.2439,61651054.97,34017028,42313781.13,15545682,19337273.84
128,2018,The Magic Tuche,47427990,0.2439,58995676.76,0,0,47427990,58995676.76
129,2018,Golden Job,47287851,0.2439,58821357.86,285795,355500.4005,47002056,58465857.46
130,2018,Mary Queen of Scots,46712809,0.2439,58106063.12,16468499,20485165.91,30244310,37620897.21
131,2018,Uncle Drew,46664414,0.2439,58045864.57,42469946,52828365.83,4194468,5217498.745
132,2018,Acrimony,46403669,0.2439,57721523.87,43549096,54170720.51,2854573,3550803.355
133,2018,Asterix: The Secret of the Magic Potion,46214871,0.2439,57486678.04,1271953,1582182.337,44942918,55904495.7
134,2018,Bajrangi Bhaijaan 2018 Re-release,45579004,0.2439,56695723.08,0,0,45579004,56695723.08
135,2018,Winchester,44019588,0.2439,54755965.51,25091816,31211709.92,18927772,23544255.59
136,2018,Annihilation,43070915,0.2439,53575911.17,32732301,40715709.21,10338614,12860201.95
137,2018,The Possession of Hannah Grace,43016528,0.2439,53508259.18,14837422,18456269.23,28179106,35051989.95
138,2018,Long Day's Journey Into Night,42140994,0.2439,52419182.44,521365,648525.9235,41619629,51770656.51
139,2018,Overlord,41657844,0.2439,51818192.15,21704844,26998655.45,19953000,24819536.7
140,2018,The Great Battle,41509280,0.2439,51633393.39,472166,587327.2874,41037114,51046066.1
141,2018,The Darkest Minds,41142379,0.2439,51177005.24,12695691,15792170.03,28446688,35384835.2
142,2018,"Lost, Found",41043552,0.2439,51054074.33,0,0,41043552,51054074.33
143,2018,Holmes & Watson,40466970,0.2439,50336863.98,30573626,38030533.38,9893344,12306330.6
144,2018,Intimate Strangers,39576060,0.2439,49228661.03,0,0,39576060,49228661.03
145,2018,Thugs of Hindostan,39570044,0.2439,49221177.73,1449848,1803465.927,38120196,47417711.8
146,2018,Sink or Swim,39193850,0.2439,48753230.02,0,0,39193850,48753230.02
147,2018,Show Dogs,39156854,0.2439,48707210.69,17857020,22212347.18,21299834,26494863.51
148,2018,Believer,39047153,0.2439,48570753.62,365639,454818.3521,38681514,48115935.26
149,2018,The Spy Gone North,38844509,0.2439,48318684.75,500803,622948.8517,38343706,47695735.89
150,2018,On the Basis of Sex,38673750,0.2439,48106277.63,24622687,30628160.36,14051063,17478117.27
151,2018,Taxi 5,38598227,0.2439,48012334.57,0,0,38598227,48012334.57
152,2018,Fat Buddies,37496410,0.2439,46641784.4,0,0,37496410,46641784.4
153,2018,Till The End Of The World,37013733,0.2439,46041382.48,118660,147601.174,36895073,45893781.3
154,2018,2,36945969,0.2439,45957090.84,4152000,5164672.8,32793969,40792418.04
155,2018,Nothing to Lose,36075317,0.2439,44874086.82,1016188,1264036.253,35059129,43610050.56
156,2018,Mia and the White Lion,35487190,0.2439,44142515.64,399471,496901.9769,35087719,43645613.66
157,2018,The Girl in the Spider's Web,35164920,0.2439,43741643.99,14841338,18461140.34,20323582,25280503.65
158,2018,The Hate U Give,34934009,0.2439,43454413.8,29719483,36968064.9,5214526,6486348.891
159,2018,Nobody's Fool,33705333,0.2439,41926063.72,31713110,39447937.53,1992223,2478126.19
160,2018,Baaghi 2,33139063,0.2439,41221680.47,1319579,1641424.318,31819484,39580256.15
161,2018,The Hurricane Heist,32517248,0.2439,40448204.79,6115825,7607474.718,26401423,32840730.07
162,2018,All About Me,31920159,0.2439,39705485.78,0,0,31920159,39705485.78
163,2018,Bad Times at the El Royale,31882724,0.2439,39658920.38,17839115,22190075.15,14043609,17468845.24
164,2018,Beautiful Boy,31711319,0.2439,39445709.7,7649973,9515801.415,24061346,29929908.29
165,2018,Hunter Killer,31672678,0.2439,39397644.16,15767460,19613143.49,15905218,19784500.67
166,2018,Super Troopers 2,31626386,0.2439,39340061.55,30617396,38084978.88,1008990,1255082.661
167,2018,The Strangers: Prey at Night,31039126,0.2439,38609568.83,24586708,30583406.08,6452418,8026162.75
168,2018,Gintama 2: Rules are Made to be Broken,30896653,0.2439,38432346.67,0,0,30896653,38432346.67
169,2018,The Way of the Bug,30355804,0.2439,37759584.6,0,0,30355804,37759584.6
170,2018,Clergy,30114115,0.2439,37458947.65,0,0,30114115,37458947.65
171,2018,Ice,29806210,0.2439,37075944.62,0,0,29806210,37075944.62
172,2018,Free Solo,29390279,0.2439,36558568.05,17541090,21819361.85,11849189,14739206.2
173,2018,Dark Figure of Crime,29176133,0.2439,36292191.84,0,0,29176133,36292191.84
174,2018,Pad Man,29045020,0.2439,36129100.38,1670192,2077551.829,27374828,34051548.55
175,2018,Mirai,28756961,0.2439,35770783.79,812794,1011034.457,27944167,34759749.33
176,2018,Default,27694043,0.2439,34448620.09,203775,253475.7225,27490268,34195144.37
177,2018,One Cut of the Dead,27590180,0.2439,34319424.9,52406,65187.8234,27537774,34254237.08
178,2018,The Happytime Murders,27506452,0.2439,34215275.64,20706452,25756755.64,6800000,8458520
179,2018,Midnight Sun,27365467,0.2439,34039904.4,9561064,11893007.51,17804403,22146896.89
180,2018,VIP Policeman,27222681,0.2439,33862292.9,0,0,27222681,33862292.9
181,2018,My Neighbor Totoro 2018 Re-release,27083857,0.2439,33689609.72,1144649,1423828.891,25939208,32265780.83
182,2018,The Faces of My Gene,26796279,0.2439,33331891.45,0,0,26796279,33331891.45
183,2018,Badhaai Ho,26125610,0.2439,32497646.28,0,0,26125610,32497646.28
184,2018,Hichki,26055222,0.2439,32410090.65,330279,410834.0481,25724943,31999256.6
185,2018,Champions,25962612,0.2439,32294893.07,0,0,25962612,32294893.07
186,2018,White Boy Rick,25957482,0.2439,32288511.86,24011188,29867516.75,1946294,2420995.107
187,2018,"Paul, Apostle of Christ",25915966,0.2439,32236870.11,17560475,21843474.85,8355491,10393395.25
188,2018,Keys to the Heart,25375866,0.2439,31565039.72,75134,93459.1826,25300732,31471580.53
189,2018,Stan & Ollie,24420923,0.2439,30377186.12,5470235,6804425.317,18950688,23572760.8
190,2018,The Witch: Part 1 - The Subversion,24340302,0.2439,30276901.66,0,0,24340302,30276901.66
191,2018,The Accidental Detective 2: In Action,24243825,0.2439,30156893.92,179045,222714.0755,24064780,29934179.84
192,2018,Killing for the Prosecution,23929620,0.2439,29766054.32,0,0,23929620,29766054.32
193,2018,Pokémon the Movie: The Power of Us,23740788,0.2439,29531166.19,789170,981648.563,22951618,28549517.63
194,2018,The Guernsey Literary and Potato Peel Pie Society,23148937,0.2439,28794962.73,0,0,23148937,28794962.73
195,2018,The Crimes That Bind,23144130,0.2439,28788983.31,0,0,23144130,28788983.31
196,2018,New Happy Dad and Son 3: Adventure in Russia,23130469,0.2439,28771990.39,0,0,23130469,28771990.39
197,2018,Padmaavat,22991060,0.2439,28598579.53,11846060,14735314.03,11145000,13863265.5
198,2018,Won't You Be My Neighbor?,22844741,0.2439,28416573.33,22835787,28405435.45,8954,11137.8806
199,2018,Europe Raiders,22435156,0.2439,27907090.55,0,0,22435156,27907090.55
200,2018,Mojin: The Worm Valley,22381583,0.2439,27840451.09,101516,126275.7524,22280067,27714175.34
201,2018,Stree,22075730,0.2439,27460000.55,0,0,22075730,27460000.55
202,2019,Avengers: Endgame,2799439100,0.222,3420914580,858373000,1048931806,1941066100,2371982774
203,2019,The Lion King,1656943394,0.222,2024784827,543638043,664325688.5,1113305351,1360459139
204,2019,Frozen II,1450026933,0.222,1771932912,477373578,583350512.3,972653355,1188582400
205,2019,Spider-Man: Far from Home,1131927996,0.222,1383216011,390532085,477230207.9,741395911,905985803.2
206,2019,Captain Marvel,1128274794,0.222,1378751798,426829839,521586063.3,701444955,857165735
207,2019,Joker,1078751311,0.222,1318234102,335451311,409921502,743300000,908312600
208,2019,Star Wars: Episode IX - The Rise of Skywalker,1074144248,0.222,1312604271,515202542,629577506.3,558941706,683026764.7
209,2019,Toy Story 4,1073394593,0.222,1311688193,434038008,530394445.8,639356585,781293746.9
210,2019,Aladdin,1050693953,0.222,1283948011,355559216,434493362,695134737,849454648.6
211,2019,Jumanji: The Next Level,801693929,0.222,979669981.2,320314960,391424881.1,481378969,588245100.1
212,2019,Fast & Furious Presents: Hobbs & Shaw,760732926,0.222,929615635.6,173956935,212575374.6,586775991,717040261
213,2019,Ne Zha,726063471,0.222,887249561.6,3695533,4515941.326,722367938,882733620.2
214,2019,The Wandering Earth,699856699,0.222,855224886.2,5971413,7297066.686,693885286,847927819.5
215,2019,How to Train Your Dragon: The Hidden World,521799505,0.222,637638995.1,160799505,196496995.1,361000000,441142000
216,2019,Maleficent: Mistress of Evil,491730089,0.222,600894168.8,113929605,139221977.3,377800484,461672191.4
217,2019,It Chapter Two,473093228,0.222,578119924.6,211593228,258566924.6,261500000,319553000
218,2019,"My People, My Country",450064993,0.222,549979421.4,2356683,2879866.626,447708310,547099554.8
219,2019,Pokémon: Detective Pikachu,433305346,0.222,529499132.8,144105346,176096732.8,289200000,353402400
220,2019,The Secret Life of Pets 2,431164459,0.222,526882968.9,158980250,194273865.5,272184209,332609103.4
221,2019,The Captain,417282021,0.222,509918629.7,706572,863430.984,416575449,509055198.7
222,2019,Alita: Battle Angel,404980543,0.222,494886223.5,85838210,104894292.6,319142333,389991930.9
223,2019,Godzilla: King of the Monsters,387300138,0.222,473280768.6,110500138,135031168.6,276800000,338249600
224,2019,1917,384580017,0.222,469956780.8,159227644,194576181,225352373,275380599.8
225,2019,Once Upon a Time... in Hollywood,377426903,0.222,461215675.5,142502728,174138333.6,234924175,287077341.9
226,2019,Shazam!,365971656,0.222,447217363.6,140371656,171534163.6,225600000,275683200
227,2019,Dumbo,353284621,0.222,431713806.9,114766307,140244427.2,238518314,291469379.7
228,2019,John Wick: Chapter 3 - Parabellum,327777335,0.222,400543903.4,171015687,208981169.5,156761648,191562733.9
229,2019,Crazy Alien,327598891,0.222,400325844.8,0,0,327598891,400325844.8
230,2019,Knives Out,312897920,0.222,382361258.2,165363234,202073871.9,147534686,180287386.3
231,2019,Terminator: Dark Fate,261119292,0.222,319087774.8,62253077,76073260.09,198866215,243014514.7
232,2019,Parasite,258098332,0.222,315396161.7,53369749,65217833.28,204728583,250178328.4
233,2019,Us,256022707,0.222,312859748,175084580,213953356.8,80938127,98906391.19
234,2019,Pegasus,255863112,0.222,312664722.9,0,0,255863112,312664722.9
235,2019,Men in Black: International,253890701,0.222,310254436.6,80001807,97762208.15,173888894,212492228.5
236,2019,Dark Phoenix,252442974,0.222,308485314.2,65845974,80463780.23,186597000,228021534
237,2019,Glass,246999039,0.222,301832825.7,111048468,135701227.9,135950571,166131597.8
238,2019,The Bravest,245179562,0.222,299609424.8,290217,354645.174,244889345,299254779.6
239,2019,Annabelle Comes Home,231252591,0.222,282590666.2,74152591,90614466.2,157100000,191976200
240,2019,Better Days,225918798,0.222,276072771.2,1921657,2348264.854,223997141,273724506.3
241,2019,Ford v Ferrari,225508210,0.222,275571032.6,117624357,143736964.3,107883853,131834068.4
242,2019,Little Women,218843645,0.222,267426934.2,108101214,132099683.5,110742431,135327250.7
243,2019,The Addams Family,203044905,0.222,248120873.9,100044905,122254873.9,103000000,125866000
244,2019,Rocketman,195320400,0.222,238681528.8,96368160,117761891.5,98952240,120919637.3
245,2019,Downton Abbey,194694725,0.222,237916954,96853865,118355423,97840860,119561530.9
246,2019,Weathering with You,192927909,0.222,235757904.8,8056636,9845209.192,184871273,225912695.6
247,2019,The Lego Movie 2: The Second Part,192306508,0.222,234998552.8,105806508,129295552.8,86500000,105703000
248,2019,Sheep Without a Shepherd,191602146,0.222,234137822.4,0,0,191602146,234137822.4
249,2019,The White Storm 2: Drug Lords,189396380,0.222,231442376.4,609461,744761.342,188786919,230697615
250,2019,Abominable,188623517,0.222,230497937.8,60716390,74195428.58,127907127,156302509.2
251,2019,Ip Man 4: The Finale,176345966,0.222,215494770.5,3956031,4834269.882,172389935,210660500.6
252,2019,Gemini Man,173469516,0.222,211979748.6,48546770,59324152.94,124922746,152655595.6
253,2019,Spies in Disguise,171616764,0.222,209715685.6,66757013,81577069.89,104859751,128138615.7
254,2019,Hustlers,157563598,0.222,192542716.8,104963598,128265516.8,52600000,64277200
255,2019,The Climbers,156892866,0.222,191723082.3,487157,595305.854,156405709,191127776.4
256,2019,Escape Room,155712077,0.222,190280158.1,57005601,69660844.42,98706476,120619313.7
257,2019,Yesterday,154608856,0.222,188932022,73286650,89556286.3,81322206,99375735.73
258,2019,The Angry Birds Movie 2,147792047,0.222,180601881.4,41667116,50917215.75,106124931,129684665.7
259,2019,Angel Has Fallen,146661977,0.222,179220935.9,69030436,84355192.79,77631541,94865743.1
260,2019,Ad Astra,127461872,0.222,155758407.6,50188370,61330188.14,77273502,94428219.44
261,2019,Midway,127420861,0.222,155708292.1,56846802,69466792.04,70574059,86241500.1
262,2019,The Upside,125852517,0.222,153791775.8,108252517,132284575.8,17600000,21507200
263,2019,Last Christmas,123446172,0.222,150851222.2,35150750,42954216.5,88295422,107897005.7
264,2019,The Curse of La Llorona,123233739,0.222,150591629.1,54733739,66884629.06,68500000,83707000
265,2019,Looking Up,122994583,0.222,150299380.4,84267,102974.274,122910316,150196406.2
266,2019,Zombieland: Double Tap,122810399,0.222,150074307.6,73123082,89356406.2,49687317,60717901.37
267,2019,Dora and the Lost City of Gold,120597108,0.222,147369666,60477943,73904046.35,60119165,73465619.63
268,2019,Extreme Job,119932733,0.222,146557799.7,1565885,1913511.47,118366848,144644288.3
269,2019,Wonder Park,119559110,0.222,146101232.4,45216793,55254921.05,74342317,90846311.37
270,2019,P Storm,117991727,0.222,144185890.4,326711,399240.842,117665016,143786649.6
271,2019,Detective Conan: The Fist of Blue Sapphire,115448200,0.222,141077700.4,0,0,115448200,141077700.4
272,2019,The Gentlemen,115171795,0.222,140739933.5,36471795,44568533.49,78700000,96171400
273,2019,Pet Sematary,113118226,0.222,138230472.2,54724696,66873578.51,58393530,71356893.66
274,2019,Boonie Bears: Blast Into the Past,112367881,0.222,137313550.6,0,0,112367881,137313550.6
275,2019,Good Boys,111173598,0.222,135854136.8,83140306,101597453.9,28033292,34256682.82
276,2019,Scary Stories to Tell in the Dark,104545505,0.222,127754607.1,68947075,84253325.65,35598430,43501281.46
277,2019,Line Walker 2: Invisible Spy,99482027,0.222,121567037,296751,362629.722,99185276,121204407.3
278,2019,The Hustle,97409779,0.222,119034749.9,35417038,43279620.44,61992741,75755129.5
279,2019,The New King of Comedy,95618308,0.222,116845572.4,0,0,95618308,116845572.4
280,2019,Adoring,94975692,0.222,116060295.6,0,0,94975692,116060295.6
281,2019,Five Feet Apart,92554209,0.222,113101243.4,45729221,55881108.06,46824988,57220135.34
282,2019,Crawl,91542097,0.222,111864442.5,39014193,47675343.85,52527904,64189098.69
283,2019,Rambo: Last Blood,91490353,0.222,111801211.4,44819352,54769248.14,46671001,57031963.22
284,2019,Jojo Rabbit,90335025,0.222,110389400.6,33370906,40779247.13,56964119,69610153.42
285,2019,Serial (Bad) Weddings 2,87761988,0.222,107245149.3,0,0,87761988,107245149.3
286,2019,One Piece: Stampede,81562741,0.222,99669669.5,1298528,1586801.216,80264213,98082868.29
287,2019,A Dog's Way Home,80708134,0.222,98625339.75,42004346,51329310.81,38703788,47296028.94
288,2019,A Dog's Journey,78870908,0.222,96380249.58,22782371,27840057.36,56088537,68540192.21
289,2019,Cold Pursuit,76419755,0.222,93384940.61,32138862,39273689.36,44280893,54111251.25
290,2019,Cats,75558925,0.222,92333006.35,27166770,33197792.94,48392155,59135213.41
291,2019,A Madea Family Funeral,74747725,0.222,91341719.95,73257045,89520108.99,1490680,1821610.96
292,2019,Charlie's Angels,73279888,0.222,89548023.14,17803077,21755360.09,55476811,67792663.04
293,2019,Doctor Sleep,72381712,0.222,88450452.06,31581712,38592852.06,40800000,49857600
294,2019,What Men Want,72216294,0.222,88248311.27,54611903,66735745.47,17604391,21512565.8
295,2019,Exit,69501772,0.222,84931165.38,470699,575194.178,69031073,84355971.21
296,2019,After,69497587,0.222,84926051.31,12138565,14833326.43,57359022,70092724.88
297,2019,Playing with Fire,69412425,0.222,84821983.35,44451847,54320157.03,24960578,30501826.32
298,2019,A Beautiful Day in the Neighborhood,67925733,0.222,83005245.73,61704055,75402355.21,6221678,7602890.516
299,2019,War,67179155,0.222,82092927.41,4654000,5687188,62525155,76405739.41
300,2019,Doraemon: Nobita's Chronicle of the Moon Exploration,65406606,0.222,79926872.53,0,0,65406606,79926872.53
301,2019,Happy Death Day 2U,64600152,0.222,78941385.74,28148130,34397014.86,36452022,44544370.88
302,2019,White Snake,62098770,0.222,75884696.94,34730,42440.06,62064040,75842256.88
303,2019,Bombshell,61404394,0.222,75036169.47,31762808,38814151.38,29641586,36222018.09
304,2019,Ashfall,61354854,0.222,74975631.59,372562,455270.764,60982292,74520360.82
305,2019,Ma,61220784,0.222,74811798.05,45896028,56084946.22,15324756,18726851.83
306,2019,My Best Summer,60011073,0.222,73333531.21,0,0,60011073,73333531.21
307,2019,Ready or Not,57615777,0.222,70406479.49,28714231,35088790.28,28901546,35317689.21
308,2019,Jade Dynasty,57149764,0.222,69837011.61,0,0,57149764,69837011.61
309,2019,The Perfect Secret,56573047,0.222,69132263.43,0,0,56573047,69132263.43
310,2019,The Big Shot,56040681,0.222,68481712.18,0,0,56040681,68481712.18
311,2019,Hellboy,55064690,0.222,67289051.18,21903748,26766380.06,33160942,40522671.12
312,2019,Les Misérables,54606372,0.222,66728986.58,330181,403481.182,54276191,66325505.4
313,2019,Long Shot,53873809,0.222,65833794.6,30316271,37046483.16,23557538,28787311.44
314,2019,Just Mercy,50901502,0.222,62201635.44,36001502,43993835.44,14900000,18207800
315,2019,Son of a Rich,50803834,0.222,62082285.15,0,0,50803834,62082285.15
316,2019,Kingdom,50574061,0.222,61801502.54,0,0,50574061,61801502.54
317,2019,Breakthrough,50444358,0.222,61643005.48,40713082,49751386.2,9731276,11891619.27
318,2019,Uncut Gems,50023780,0.222,61129059.16,50023780,61129059.16,0,0
319,2019,21 Bridges,49939757,0.222,61026383.05,28539757,34875583.05,21400000,26150800
320,2019,Song of Youth,49615508,0.222,60630150.78,0,0,49615508,60630150.78
321,2019,The Grudge,49511319,0.222,60502831.82,21221803,25933043.27,28289516,34569788.55
322,2019,Little,48987096,0.222,59862231.31,40860481,49931507.78,8126615,9930723.53
323,2019,Isn't It Romantic,48791187,0.222,59622830.51,48791187,59622830.51,0,0
324,2019,The Legend of Hei,48507082,0.222,59275654.2,0,0,48507082,59275654.2
325,2019,Countdown,48021766,0.222,58682598.05,25621766,31309798.05,22400000,27372800
326,2019,Midsommar,47863365,0.222,58489032.03,27426361,33515013.14,20437004,24974018.89
327,2019,Queen & Slim,47834125,0.222,58453300.75,43808310,53533754.82,4025815,4919545.93
328,2019,47 Meters Down: Uncaged,47582563,0.222,58145891.99,22260900,27202819.8,25321663,30943072.19
329,2019,Chasing the Dragon II: Wild Wild Bunch,45733356,0.222,55886161.03,196634,240286.748,45536722,55645874.28
330,2019,Judy,45701880,0.222,55847697.36,24313888,29711571.14,21387992,26136126.22
331,2019,Child's Play,44907074,0.222,54876444.43,29208403,35692668.47,15698671,19183775.96
332,2019,Richard Jewell,44645542,0.222,54556852.32,22345542,27306252.32,22300000,27250600
333,2019,Harriet,43347017,0.222,52970054.77,43082155,52646393.41,264862,323661.364
334,2019,A Shaun the Sheep Movie: Farmageddon,43100248,0.222,52668503.06,0,0,43100248,52668503.06
335,2019,Fighting with My Family,41503392,0.222,50717145.02,22958886,28055758.69,18544506,22661386.33
336,2019,Masquerade Hotel,40396244,0.222,49364210.17,0,0,40396244,49364210.17
337,2019,The Last Wish,39756292,0.222,48582188.82,0,0,39756292,48582188.82
338,2019,Uri: The Surgical Strike,39346577,0.222,48081517.09,4186168,5115497.296,35160409,42966019.8
339,2019,Overcomer,38026103,0.222,46467897.87,34746945,42460766.79,3279158,4007131.076
340,2019,T-34,37410850,0.222,45716058.7,0,0,37410850,45716058.7
341,2019,Pain and Glory,37359689,0.222,45653539.96,4567338,5581287.036,32792351,40072252.92
342,2019,A Witness Out of the Blue,37092694,0.222,45327272.07,0,0,37092694,45327272.07
343,2019,The Intruder,36599361,0.222,44724419.14,35419122,43282167.08,1180239,1442252.058
344,2019,The Queen's Corgi,35515687,0.222,43400169.51,0,0,35515687,43400169.51
345,2019,Warrior of the Hornor,34291831,0.222,41904617.48,0,0,34291831,41904617.48
346,2019,The Battle: Roar to Victory,34148707,0.222,41729719.95,0,0,34148707,41729719.95
347,2019,The Bad Guys: The Movie,34024386,0.222,41577799.69,166972,204039.784,33857414,41373759.91
348,2019,The Good Liar,33856058,0.222,41372102.88,17156058,20964702.88,16700000,20407400
349,2019,The Art of Racing in the Rain,33766787,0.222,41263013.71,26395642,32255474.52,7371145,9007539.19
350,2019,Brightburn,33224654,0.222,40600527.19,17300439,21141136.46,15924215,19459390.73
351,2019,Bharat,33185983,0.222,40553271.23,2971549,3631232.878,30214434,36922038.35
352,2019,Fly Me to the Saitama,32802347,0.222,40084468.03,0,0,32802347,40084468.03
353,2019,UglyDolls,32450241,0.222,39654194.5,20150241,24623594.5,12300000,15030600
354,2019,Stuber,32390945,0.222,39581734.79,22370452,27336692.34,10020493,12245042.45
355,2019,Hit Me Anyone One More Time!,32333512,0.222,39511551.66,0,0,32333512,39511551.66
356,2019,Somewhere Winter,32218990,0.222,39371605.78,0,0,32218990,39371605.78
357,2019,The Kid Who Would Be King,32140970,0.222,39276265.34,16790790,20518345.38,15350180,18757919.96
358,2019,Two Tigers,32001580,0.222,39105930.76,0,0,32001580,39105930.76
359,2019,Anna,31626978,0.222,38648167.12,7743794,9462916.268,23883184,29185250.85
360,2019,My Dear Liar,31177968,0.222,38099476.9,90545,110645.99,31087423,37988830.91
361,2019,The Wild Goose Lake,31064835,0.222,37961228.37,12573,15364.206,31052262,37945864.16
362,2019,My Hero Academia: Heroes Rising,29971229,0.222,36624841.84,13304000,16257488,16667229,20367353.84
363,2019,Fall In Love At First Kiss,29206238,0.222,35690022.84,0,0,29206238,35690022.84
364,2019,Gully Boy,28299498,0.222,34581986.56,5566534,6802304.548,22732964,27779682.01
365,2019,Kim Ji-young: Born 1982,27696393,0.222,33844992.25,0,0,27696393,33844992.25
366,2019,Pokémon: Mewtwo Strikes Back - Evolution,27347118,0.222,33418178.2,0,0,27347118,33418178.2
367,2019,Almost a Comedy,26990962,0.222,32982955.56,0,0,26990962,32982955.56
368,2019,Total Dhamaal,26911995,0.222,32886457.89,2167632,2648846.304,24744363,30237611.59
369,2019,Missing Link,26565710,0.222,32463297.62,16649539,20345736.66,9916171,12117560.96
370,2019,No Manches Frida 2,26493648,0.222,32375237.86,9270920,11329064.24,17222728,21046173.62
371,2019,The Confidence Man JP,26228317,0.222,32051003.37,0,0,26228317,32051003.37
372,2019,The Confidence Man JP: The Movie,25958189,0.222,31720906.96,0,0,25958189,31720906.96
373,2019,"The Gangster, the Cop, the Devil",25775371,0.222,31497503.36,216494,264555.668,25558877,31232947.69
374,2019,Bodies at Rest,25293853,0.222,30909088.37,0,0,25293853,30909088.37
375,2019,Booksmart,24959607,0.222,30500639.75,22680962,27716135.56,2278645,2784504.19
376,2019,Super 30,24701637,0.222,30185400.41,2269878,2773790.916,22431759,27411609.5
377,2019,Skyfire,24444590,0.222,29871288.98,1105,1350.31,24443485,29869938.67
378,2019,Start-Up,24106579,0.222,29458239.54,0,0,24106579,29458239.54
379,2019,Pinocchio,23841090,0.222,29133811.98,1831718,2238359.396,22009372,26895452.58
380,2019,A Rainy Day in New York,23805899,0.222,29090808.58,0,0,23805899,29090808.58
381,2019,The Peanut Butter Falcon,23712090,0.222,28976173.98,20457151,24998638.52,3254939,3977535.458
382,2019,Little White Lies 2,23623665,0.222,28868118.63,0,0,23623665,28868118.63
383,2019,Ossan's Love: Love or Dead,23422744,0.222,28622593.17,0,0,23422744,28622593.17
384,2019,Only Cloud Knows,23414998,0.222,28613127.56,0,0,23414998,28613127.56
385,2019,Dark Waters,23108017,0.222,28237996.77,11136084,13608294.65,11971933,14629702.13
386,2019,The Farewell,23076657,0.222,28199674.85,17695781,21624244.38,5380876,6575430.472
387,2019,The Knight of Shadows: Between Yin and Yang,22936257,0.222,28028106.05,0,0,22936257,28028106.05
388,2019,Black and Blue,22741061,0.222,27789576.54,22055313,26951592.49,685748,837984.056
389,2019,Late Night,22386555,0.222,27356370.21,15499454,18940332.79,6887101,8416037.422
390,2019,Unplanned,21585326,0.222,26377268.37,19005109,23224243.2,2580217,3153025.174
391,2019,Crazy Romance,21386368,0.222,26134141.7,0,0,21386368,26134141.7
392,2019,Shaft,21360215,0.222,26102182.73,21360215,26102182.73,0,0
393,2019,Hotel Mumbai,21314816,0.222,26046705.15,9651611,11794268.64,11663205,14252436.51
394,2019,Integrity,21290004,0.222,26016384.89,0,0,21290004,26016384.89
395,2019,The Secret Mission,21083522,0.222,25764063.88,0,0,21083522,25764063.88
396,2019,This Is Tomas,20084169,0.222,24542854.52,0,0,20084169,24542854.52
397,2019,The Specials,19363826,0.222,23662595.37,0,0,19363826,23662595.37
398,2019,Always Miss You,19015465,0.222,23236898.23,91884,112282.248,18923581,23124615.98
399,2019,An Officer and a Spy,18899214,0.222,23094839.51,0,0,18899214,23094839.51
400,2019,Crayon Shin-chan: Honeymoon Hurricane - The Lost Hiroshi,18738951,0.222,22898998.12,0,0,18738951,22898998.12
401,2019,Greta,18653107,0.222,22794096.75,10532219,12870371.62,8120888,9923725.136
402,2020,The Eight Hundred,461421559,0.207,556935821.7,372755,449915.285,461048804,556485906.4
403,2020,Demon Slayer: Kimetsu no Yaiba - The Movie: Mugen Train,453230408,0.207,547049102.5,49505008,59752544.66,403725400,487296557.8
404,2020,Bad Boys for Life,426505244,0.207,514791829.5,206305244,249010429.5,220200000,265781400
405,2020,"My People, My Homeland",422390820,0.207,509825719.7,0,0,422390820,509825719.7
406,2020,Tenet,365304105,0.207,440922054.7,58504105,70614454.74,306800000,370307600
407,2020,Sonic the Hedgehog,319715683,0.207,385896829.4,148974665,179812420.7,170741018,206084408.7
408,2020,Dolittle,251410631,0.207,303452631.6,77047065,92995807.46,174363566,210456824.2
409,2020,Jiang Ziya,240646355,0.207,290460150.5,214670,259106.69,240431685,290201043.8
410,2020,A Little Red Flower,216000000,0.207,260712000,0,0,216000000,260712000
411,2020,The Croods: A New Age,215905815,0.207,260598318.7,58568815,70692559.71,157337000,189905759
412,2020,Birds of Prey,205358461,0.207,247867662.4,84158461,101579262.4,121200000,146288400
413,2020,Shock Wave 2,198921659,0.207,240098442.4,0,0,198921659,240098442.4
414,2020,Wonder Woman 1984,169601036,0.207,204708450.5,46801036,56488850.45,122800000,148219600
415,2020,The Sacrifice,161047608,0.207,194384462.9,0,0,161047608,194384462.9
416,2020,The Invisible Man,144492724,0.207,174402717.9,70410000,84984870,74082724,89417847.87
417,2020,Onward,141940042,0.207,171321630.7,61555145,74297060.02,80384897,97024570.68
418,2020,Warm Hug,129240236,0.207,155992964.9,0,0,129240236,155992964.9
419,2020,Soul,121903885,0.207,147137989.2,946154,1142007.878,120957731,145995981.3
420,2020,The Call of the Wild,111166669,0.207,134178169.5,62342368,75247238.18,48824301,58930931.31
421,2020,Mamma Mia! 2020 Re-release,84604815,0.207,102118011.7,0,0,84579977,102088032.2
422,2020,Caught in Time,80543319,0.207,97215786.03,0,0,80543319,97215786.03
423,2020,Mulan,69965374,0.207,84448206.42,0,0,69965374,84448206.42
424,2020,The Yin-Yang Master: Dream of Eternity,68000000,0.207,82076000,0,0,68000000,82076000
425,2020,Stand by Me Doraemon 2,65201374,0.207,78698058.42,0,0,65201374,78698058.42
426,2020,The Rescue,64237554,0.207,77534727.68,18797,22687.979,64218757,77512039.7
427,2020,Love You Forever,60670799,0.207,73229654.39,0,0,60670799,73229654.39
428,2020,Greenland,52300000,0.207,63126100,0,0,52300000,63126100
429,2020,Tolo Tolo,52186426,0.207,62989016.18,0,0,52186426,62989016.18
430,2020,Vanguard,50866901,0.207,61396349.51,793525,957784.675,50073376,60438564.83
431,2020,Fantasy Island,49447308,0.207,59682900.76,27309289,32962311.82,22138019,26720588.93
432,2020,Trolls World Tour,49276818,0.207,59477119.33,450000,543150,48826818,58933969.33
433,2020,The New Mutants,49169594,0.207,59347699.96,23852659,28790159.41,25316935,30557540.55
434,2020,After We Collided,47990414,0.207,57924429.7,2386483,2880484.981,45603931,55043944.72
435,2020,"From Today, It's My Turn: The Movie",47895887,0.207,57810335.61,0,0,47895887,57810335.61
436,2020,Tanhaji: The Unsung Warrior,45221814,0.207,54582729.5,0,0,45221814,54582729.5
437,2020,Unhinged,44331465,0.207,53508078.26,20831465,25143578.26,23500000,28364500
438,2020,The End of Endless Love,43950000,0.207,53047650,0,0,43950000,53047650
439,2020,The War with Grandpa,43387638,0.207,52368879.07,21277892,25682415.64,22109746,26686463.42
440,2020,Peninsula,42698327,0.207,51536880.69,1231407,1486308.249,41466920,50050572.44
441,2020,Monster Hunter,42145959,0.207,50870172.51,15162470,18301101.29,26983489,32569071.22
442,2020,Underwater,40882928,0.207,49345694.1,17291078,20870331.15,23591850,28475362.95
443,2020,Bloodshot,39861118,0.207,48112369.43,12561824,15162121.57,27299294,32950247.86
444,2020,Sarileru Neekevvaru,37389889,0.207,45129596.02,821000,990947,36568889,44138649.02
445,2020,The Untold Tale of the Three Kingdoms,36747486,0.207,44354215.6,0,0,36747486,44354215.6
446,2020,The Confidence Man JP: Princess,36109913,0.207,43584664.99,0,0,36109913,43584664.99
447,2020,The Man Standing Next,34664900,0.207,41840534.3,113527,137027.089,34551373,41703507.21
448,2020,My Mom is a Character 3,34360029,0.207,41472555,0,0,34360029,41472555
449,2020,Doraemon the Movie: Nobita's New Dinosaur,34218525,0.207,41301759.68,0,0,34218525,41301759.68
450,2020,Deliver Us from Evil,33718703,0.207,40698474.52,0,0,33718703,40698474.52
451,2020,Harry Potter and the Sorcerer's Stone 2020 Re-release,31503136,0.207,38024285.15,0,0,31501815,38022690.71
452,2020,Honest Thief,31220247,0.207,37682838.13,14163574,17095433.82,17056673,20587404.31
453,2020,Like a Boss,30399490,0.207,36692184.43,22169514,26758603.4,8229976,9933581.032
454,2020,The Witches,29303571,0.207,35369410.2,203571,245710.197,29100000,35123700
455,2020,Bath Buddy,28700000,0.207,34640900,0,0,28700000,34640900
456,2020,Scoob!,28588425,0.207,34506228.98,2188425,2641428.975,26400000,31864800
457,2020,Ala Vaikunthapurramuloo,28477890,0.207,34372813.23,0,0,28477890,34372813.23
458,2020,Emma.,26404660,0.207,31870424.62,10055355,12136813.49,16349305,19733611.14
459,2020,Leap,25818882,0.207,31163390.57,83074,100270.318,25735808,31063120.26
460,2020,Gravity 2020 Re-release,24857278,0.207,30002734.55,0,0,24857244,30002693.51
461,2020,The Father,24048935,0.207,29027064.55,2122771,2562184.597,21920547,26458100.23
462,2020,Poupelle of Chimney Town,22715146,0.207,27417181.22,0,0,22715146,27417181.22
463,2020,Gretel & Hansel,22304357,0.207,26921358.9,15347654,18524618.38,6956703,8396740.521
464,2020,Moana 2020 Re-release,21737046,0.207,26236614.52,0,0,21736672,26236163.1
465,2020,Stigmatized Properties,21276720,0.207,25681001.04,0,0,21276720,25681001.04
466,2020,Pokémon the Movie: Secrets of the Jungle,21097921,0.207,25465190.65,0,0,21097921,25465190.65
467,2020,The Photograph,20690779,0.207,24973770.25,20578185,24837869.3,112594,135900.958
468,2020,Threads - Our Tapestry of Love,20474270,0.207,24712443.89,0,0,20474270,24712443.89
469,2020,Violet Evergarden: The Movie,20339624,0.207,24549926.17,0,0,20339624,24549926.17
470,2020,Brahms: The Boy II,20311536,0.207,24516023.95,12611536,15222123.95,7700000,9293900
471,2020,Interstellar 2020 Re-release,19990000,0.207,24127930,0,0,19990000,24127930
472,2020,Ice 2,19788995,0.207,23885316.97,0,0,19788995,23885316.97
473,2020,Soul Snatcher,19561221,0.207,23610393.75,0,0,19561221,23610393.75
474,2020,The Turning,19428166,0.207,23449796.36,15472775,18675639.43,3955391,4774156.937
475,2020,Fate/stay night [Heaven's Feel] III. spring song,19252497,0.207,23237763.88,200000,241400,19052497,22996363.88
476,2020,Promising Young Woman,18854166,0.207,22756978.36,6460965,7798384.755,12393201,14958593.61
477,2020,Takizawa Enbujo Zero,18091395,0.207,21836313.77,0,0,18091395,21836313.77
478,2020,Freaky,18073433,0.207,21814633.63,9030855,10900241.99,9042578,10914391.65
479,2020,The Promised Neverland,17710977,0.207,21377149.24,0,0,17710977,21377149.24
480,2020,Kaiji: Final Game,17645779,0.207,21298455.25,0,0,17645779,21298455.25
481,2020,Hitman: Agent Jun,17601351,0.207,21244830.66,0,0,17601351,21244830.66
482,2020,Digimon Adventure: Last Evolution Kizuna,17361009,0.207,20954737.86,0,0,17361009,20954737.86
483,2020,Bye Bye Morons,16955924,0.207,20465800.27,0,0,16955924,20465800.27
484,2020,Baaghi 3,16726510,0.207,20188897.57,721439,870776.873,16005071,19318120.7
485,2020,I Still Believe,16069730,0.207,19396164.11,9868521,11911304.85,6201209,7484859.263
486,2020,The Way Back,15490514,0.207,18697050.4,13590514,16403750.4,1900000,2293300
487,2020,Father There is Only One 2,15373181,0.207,18555429.47,0,0,15373181,18555429.47
488,2020,The Personal History of David Copperfield,14399270,0.207,17379918.89,1876298,2264691.686,12522972,15115227.2
489,2020,Nightlife,14308789,0.207,17270708.32,0,0,14308789,17270708.32
490,2020,Pawn,14193957,0.207,17132106.1,0,0,14193957,17132106.1
491,2020,The Post 2020 Re-release,13995207,0.207,16892214.85,0,0,13995207,16892214.85
492,2020,#Alive,13432212,0.207,16212679.88,0,0,13432212,16212679.88
493,2020,Howling Village,13394556,0.207,16167229.09,0,0,13394556,16167229.09
494,2020,Come Play,13182254,0.207,15910980.58,10475990,12644519.93,2706264,3266460.648
495,2020,Samjin Company English Class,12761386,0.207,15402992.9,0,0,12761386,15402992.9
496,2020,Another Round,12745392,0.207,15383688.14,0,0,12742455,15380143.19
497,2020,News of the World,12668325,0.207,15290668.28,12668325,15290668.28,0,0
498,2020,Collectors,12640113,0.207,15256616.39,0,0,12640113,15256616.39
499,2020,Shinchan: Crash! Scribble Kingdom and Almost Four Heroes,12221804,0.207,14751717.43,0,0,12221804,14751717.43
500,2020,Ducobu 3,12157793,0.207,14674456.15,0,0,12157793,14674456.15
501,2020,The Asadas,11888743,0.207,14349712.8,0,0,11888743,14349712.8
502,2020,Wotakoi: Love Is Hard for Otaku,11702371,0.207,14124761.8,0,0,11702371,14124761.8
503,2020,30 jours max,11007713,0.207,13286309.59,0,0,11007713,13286309.59
504,2020,Bigfoot Family,10987975,0.207,13262485.83,0,0,10987975,13262485.83
505,2020,The Voice of Sin,10983063,0.207,13256557.04,0,0,10983063,13256557.04
506,2020,Two by Two: Overboard!,10885076,0.207,13138286.73,0,0,10885076,13138286.73
507,2020,Let Him Go,10835686,0.207,13078673,9358025,11295136.18,1477661,1783536.827
508,2020,One Second,10791301,0.207,13025100.31,0,0,10791301,13025100.31
509,2020,Me contro Te - Il film: La vendetta del Signor S,10779891,0.207,13011328.44,0,0,10779891,13011328.44
510,2020,Impractical Jokers: The Movie,10691091,0.207,12904146.84,10691091,12904146.84,0,0
511,2020,Honest Candidate,10597464,0.207,12791139.05,0,0,10597464,12791139.05
512,2020,The Hunt,10550350,0.207,12734272.45,5812500,7015687.5,4737850,5718584.95
513,2020,Street Dancer 3D,10339127,0.207,12479326.29,0,0,10339127,12479326.29
514,2020,My Spy,10200000,0.207,12311400,0,0,10200000,12311400
515,2020,100% Wolf,9766489,0.207,11788152.22,658764,795128.148,9107725,10993024.08
516,2020,Stolen Identity 2,9687188,0.207,11692435.92,0,0,9687188,11692435.92
517,2020,Inception 10th Anniversary re-release,9581100,0.207,11564387.7,0,0,9581100,11564387.7
518,2020,10 Days with Dad,9472077,0.207,11432796.94,2359,2847.313,9469718,11429949.63
519,2020,Secret Zoo,9471940,0.207,11432631.58,0,0,9471940,11432631.58
520,2020,365 Days,9458590,0.207,11416518.13,0,0,9458590,11416518.13
521,2020,Okay Madam,9433525,0.207,11386264.68,0,0,9433525,11386264.68
522,2020,L'appel de la forêt,9317347,0.207,11246037.83,0,0,9317347,11246037.83
523,2020,The Closet,9039424,0.207,10910584.77,0,0,9039424,10910584.77
524,2020,Malasaña 32,8968845,0.207,10825395.92,0,0,8968845,10825395.92
525,2020,Break the Silence: The Movie,8954345,0.207,10807894.42,0,0,8954345,10807894.42
526,2020,I Hate Summer,8926071,0.207,10773767.7,0,0,8926071,10773767.7
527,2020,Downhill,8899195,0.207,10741328.37,8287061,10002482.63,612134,738845.738
528,2020,Les blagues de Toto,8859185,0.207,10693036.3,0,0,8859185,10693036.3
529,2020,The Secret Garden,8721243,0.207,10526540.3,0,0,8721243,10526540.3
530,2020,War of the Eltis,8613864,0.207,10396933.85,0,0,8613864,10396933.85
531,2020,Malang,8399765,0.207,10138516.36,0,0,8399765,10138516.36
532,2020,Your Eyes Tell,8020474,0.207,9680712.118,0,0,8020474,9680712.118
533,2020,"My Donkey, My Lover & I",7974769,0.207,9625546.183,152184,183686.088,7821615,9440689.305
534,2020,AI Amok,7932191,0.207,9574154.537,0,0,7932191,9574154.537
535,2020,The Lost Prince,7837980,0.207,9460441.86,0,0,7837980,9460441.86
536,2020,Antebellum,7792716,0.207,9405808.212,0,0,7792716,9405808.212
537,2020,The Marriage Escape,7760946,0.207,9367461.822,0,0,7760946,9367461.822
538,2020,Spirited Away Studio Ghibli Fest 2020,7732697,0.207,9333365.279,0,0,7732435,9333049.045
539,2020,Princess Mononoke Studio Ghibli Fest 2020,7673800,0.207,9262276.6,0,0,7673207,9261560.849
540,2020,The Heist of the Century,7627100,0.207,9205909.7,0,0,7627100,9205909.7
541,2020,De Gaulle,7501454,0.207,9054254.978,0,0,7501454,9054254.978
542,2020,Fukushima 50,7494243,0.207,9045551.301,0,0,7494243,9045551.301
543,2020,The Best Years,7355020,0.207,8877509.14,0,0,7355020,8877509.14
544,2020,Mamma Mia! Here We Go Again 2020 Re-release,7225624,0.207,8721328.168,0,0,7220137,8714705.359
545,2020,Bohemian Rhapsody 2020 Re-release,7158262,0.207,8640022.234,240000,289680,6914052,8345260.764
546,2020,The (UN)perfect Guy,7154649,0.207,8635661.343,0,0,7154649,8635661.343
547,2020,Spycies,7128952,0.207,8604645.064,0,0,7128952,8604645.064
548,2020,Back to the Wharf,7090000,0.207,8557630,0,0,7090000,8557630
549,2020,Adu,7085946,0.207,8552736.822,0,0,7085946,8552736.822
550,2020,Fatale,7031289,0.207,8486765.823,6306897,7612424.679,724392,874341.144
551,2020,Dragon Rider,6977378,0.207,8421695.246,0,0,6977378,8421695.246
552,2020,Jim Button and the Wild 13,6933267,0.207,8368453.269,0,0,6933267,8368453.269
553,2020,Psy 3: W imie zasad,6725146,0.207,8117251.222,0,0,6725146,8117251.222
554,2020,Blood Moon Party,6709383,0.207,8098225.281,0,0,6709383,8098225.281
555,2020,Innocence,6688330,0.207,8072814.31,0,0,6659968,8038581.376
556,2020,Shubh Mangal Zyada Saavdhan,6574905,0.207,7935910.335,0,0,6574905,7935910.335
557,2020,Chhapaak,6532100,0.207,7884244.7,604334,729431.138,5927766,7154813.562
558,2020,"Love Me, Love Me Not",6494241,0.207,7838548.887,0,0,6494241,7838548.887
559,2020,Hammamet,6434874,0.207,7766892.918,0,0,6434874,7766892.918
560,2020,Lindenberg! Mach dein Ding,6404964,0.207,7730791.548,0,0,6404964,7730791.548
561,2020,Midnight Swan,6397065,0.207,7721257.455,0,0,6397065,7721257.455
562,2020,Nausicaä of the Valley of the Wind 2020 Re-release,6395525,0.207,7719398.675,0,0,6395525,7719398.675
563,2020,Simply Black,6323750,0.207,7632766.25,0,0,6323750,7632766.25
564,2020,My Boyfriend's Meds,6292780,0.207,7595385.46,2971116,3586137.012,3321664,4009248.448
565,2020,Bill & Ted Face the Music,6274027,0.207,7572750.589,3439660,4151669.62,2834367,3421080.969
566,2020,Hotel Belgrade,6189882,0.207,7471187.574,0,0,6189882,7471187.574
567,2020,How to Be a Good Wife,6033430,0.207,7282350.01,0,0,6033430,7282350.01
568,2020,The Legacy Of Dr. Death: Black File,6024046,0.207,7271023.522,0,0,6024046,7271023.522
569,2020,A Piece of Cake,6008448,0.207,7252196.736,0,0,6008448,7252196.736
570,2020,The Rhythm Section,5989583,0.207,7229426.681,5437971,6563630.997,551612,665795.684
571,2020,How I Became a Gangster,5975729,0.207,7212704.903,0,0,5975729,7212704.903
572,2020,The Innocent,5929392,0.207,7156776.144,22549,27216.643,5906843,7129559.501
573,2020,Twiceborn,5880157,0.207,7097349.499,11527,13913.089,5868630,7083436.41
574,2020,The Royal Bride,5830719,0.207,7037677.833,0,0,5830719,7037677.833
575,2020,Beasts Clawing at Straws,5796059,0.207,6995843.213,0,0,5796059,6995843.213
576,2020,The Lion King 2020 Re-release,5773266,0.207,6968332.062,0,0,5773266,6968332.062
577,2020,Last Letter,5663972,0.207,6836414.204,0,0,5663972,6836414.204
578,2020,Yowamushi Pedal: The Movie 2020 Re-release,5624218,0.207,6788431.126,0,0,5624218,6788431.126
579,2020,Hocus Pocus 2020 Re-release,5609193,0.207,6770295.951,4828000,5827396,781193,942899.951
580,2020,Klassikokkutulek 2: Pulmad ja matused,5543147,0.207,6690578.429,0,0,5543147,6690578.429
581,2020,Mama Weed,5461144,0.207,6591600.808,29151,35185.257,5431993,6556415.551
582,2020,Divorce Club,5316313,0.207,6416789.791,0,0,5316313,6416789.791
583,2020,Cats & Dogs 3: Paws Unite,5300000,0.207,6397100,0,0,5300000,6397100
584,2020,Cindy La Regia,5222322,0.207,6303342.654,0,0,5222322,6303342.654
585,2020,Run,5184368,0.207,6257532.176,0,0,5184368,6257532.176
586,2020,Love Aaj Kal,5120794,0.207,6180798.358,0,0,5120794,6180798.358
587,2020,Masked Ward,5107013,0.207,6164164.691,0,0,5107013,6164164.691
588,2020,Ayyappanum Koshiyum,5088713,0.207,6142076.591,0,0,5088713,6142076.591
589,2020,Baba Parasi,5084342,0.207,6136800.794,0,0,5084342,6136800.794
590,2020,Die Känguru-Chroniken,5081127,0.207,6132920.289,0,0,5081127,6132920.289
591,2020,The Real Exorcist,5035830,0.207,6078246.81,0,0,5035830,6078246.81
592,2020,Mayday,5011408,0.207,6048769.456,0,0,5011408,6048769.456
593,2020,Bheeshma,4997080,0.207,6031475.56,0,0,4997080,6031475.56
594,2020,Made in Abyss: Dawn of the Deep Soul,4971635,0.207,6000763.445,0,0,4971635,6000763.445
595,2020,Godai - The Wunderkind,4948225,0.207,5972507.575,0,0,4948225,5972507.575
596,2020,Military Wives,4890505,0.207,5902839.535,0,0,4890505,5902839.535
597,2020,Panga,4886124,0.207,5897551.668,582720,703343.04,4303404,5194208.628
598,2020,The Tales for Old and Young,4853143,0.207,5857743.601,0,0,4853143,5857743.601
599,2020,Streltsov,4850073,0.207,5854038.111,0,0,4850073,5854038.111
600,2020,Persian Lessons,4849240,0.207,5853032.68,0,0,4849240,5853032.68
601,2020,The SpongeBob Movie: Sponge on the Run,4810790,0.207,5806623.53,4810790,5806623.53,0,0
602,2021,Spider-Man: No Way Home,1912233593,0.153,2204805333,804793477,927926879,1107440116,1276878454
603,2021,The Battle at Lake Changjin,902548476,0.153,1040638393,342411,394799.883,902206065,1040243593
604,2021,"Hi, Mom",822009764,0.153,947777257.9,0,0,822009764,947777257.9
605,2021,No Time to Die,774153007,0.153,892598417.1,160891007,185507331.1,613262000,707091086
606,2021,F9: The Fast Saga,726229501,0.153,837342614.7,173005945,199475854.6,553223556,637866760.1
607,2021,Detective Chinatown 3,686257563,0.153,791254970.1,0,0,686257563,791254970.1
608,2021,Venom: Let There Be Carnage,506863592,0.153,584413721.6,213550366,246223572,293313226,338190149.6
609,2021,Godzilla vs. Kong,470116094,0.153,542043856.4,100916094,116356256.4,369200000,425687600
610,2021,Shang-Chi and the Legend of the Ten Rings,432243292,0.153,498376515.7,224543292,258898415.7,207700000,239478100
611,2021,Sing 2,408402685,0.153,470888295.8,162790990,187698011.5,245611695,283190284.3
612,2021,Eternals,402064899,0.153,463580828.5,164870234,190095379.8,237194665,273485448.7
613,2021,Dune,402027830,0.153,463538088,108327830,124901988,293700000,338636100
614,2021,Black Widow,379751655,0.153,437853658.2,183651655,211750358.2,196100000,226103300
615,2021,Free Guy,331526598,0.153,382250167.5,121626598,140235467.5,209900000,242014700
616,2021,A Quiet Place Part II,297372261,0.153,342870216.9,160072261,184563316.9,137300000,158306900
617,2021,Encanto,256786742,0.153,296075113.5,96093622,110795946.2,160693120,185279167.4
618,2021,Cruella,233503234,0.153,269229228.8,86103234,99277028.8,147400000,169952200
619,2021,"My Country, My Parents",221831086,0.153,255771242.2,177133,204234.349,221653953,255567007.8
620,2021,Jungle Cruise,220889446,0.153,254685531.2,116987516,134886605.9,103901930,119798925.3
621,2021,The Conjuring: The Devil Made Me Do It,206431050,0.153,238015000.7,65631050,75672600.65,140800000,162342400
622,2021,Raging Fire,205842393,0.153,237336279.1,385305,444256.665,205457088,236892022.5
623,2021,Ghostbusters: Afterlife,204334455,0.153,235597626.6,129360575,149152743,74973880,86444883.64
624,2021,Chinese Doctors,197143218,0.153,227306130.4,0,0,197143218,227306130.4
625,2021,Cliff Walkers,181325565,0.153,209068376.4,152972,176376.716,181172593,208891999.7
626,2021,The Suicide Squad,168717425,0.153,194531191,55817425,64357491.03,112900000,130173700
627,2021,Jujutsu Kaisen 0,166760828,0.153,192275234.7,34542754,39827795.36,132218074,152447439.3
628,2021,Space Jam: A New Legacy,163692228,0.153,188737138.9,70592228,81392838.88,93100000,107344300
629,2021,The Matrix Resurrections,157386805,0.153,181466986.2,37686805,43452886.17,119700000,138014100
630,2021,Peter Rabbit 2: The Runaway,153901717,0.153,177448679.7,40501717,46698479.7,113400000,130750200
631,2021,House of Gucci,153269161,0.153,176719342.6,53809574,62042438.82,99459587,114676903.8
632,2021,A Writer's Odyssey,150123320,0.153,173092188,160013,184494.989,149963307,172907693
633,2021,The Boss Baby 2: Family Business,146745280,0.153,169197307.8,57300280,66067222.84,89445000,103130085
634,2021,PAW Patrol: The Movie,144327371,0.153,166409458.8,40127371,46266858.76,104200000,120142600
635,2021,Tom & Jerry,136536687,0.153,157426800.1,46536687,53656800.11,90000000,103770000
636,2021,Be Somebody,132326332,0.153,152572260.8,0,0,132326332,152572260.8
637,2021,Halloween Kills,131647155,0.153,151789169.7,92002155,106078484.7,39645000,45710685
638,2021,Raya and the Last Dragon,130423032,0.153,150377755.9,54723032,63095655.9,75700000,87282100
639,2021,Sister,128317206,0.153,147949738.5,0,0,128317206,147949738.5
640,2021,The King's Man,125897478,0.153,145159792.1,37176373,42864358.07,88721105,102295434.1
641,2021,The Addams Family 2,119815153,0.153,138146871.4,56489153,65131993.41,63326000,73014878
642,2021,My Love,116720921,0.153,134579221.9,86252,99448.556,116634669,134479773.4
643,2021,Clifford the Big Red Dog,107347356,0.153,123771501.5,48947356,56436301.47,58400000,67335200
644,2021,Wrath of Man,103966489,0.153,119873361.8,27466489,31668861.82,76500000,88204500
645,2021,Detective Conan: The Scarlet Bullet,95371578,0.153,109963429.4,0,0,95371578,109963429.4
646,2021,Evangelion: 3.0+1.01 Thrice Upon a Time,93882453,0.153,108246468.3,810744,934787.832,93071709,107311680.5
647,2021,End Game,91824961,0.153,105874180,23149,26690.797,91801812,105847489.2
648,2021,Old,90146510,0.153,103938926,48276510,55662816.03,41870000,48276110
649,2021,Mortal Kombat,84426031,0.153,97343213.74,42326031,48801913.74,42100000,48541300
650,2021,Boonie Bears: The Wild Life,78132231,0.153,90086462.34,0,0,78132231,90086462.34
651,2021,Candyman,77411570,0.153,89255540.21,61186570,70548115.21,16225000,18707425
652,2021,The Forever Purge,76994245,0.153,88774364.49,44539245,51353749.49,32455000,37420615
653,2021,West Side Story,76016171,0.153,87646645.16,38530322,44425461.27,37485849,43221183.9
654,2021,1921,75159828,0.153,86659281.68,0,0,75159828,86659281.68
655,2021,Hitman's Wife's Bodyguard,70060492,0.153,80779747.28,38014727,43830980.23,32045765,36948767.05
656,2021,Escape Room: Tournament of Champions,65774490,0.153,75837986.97,25314753,29187910.21,40459737,46650076.76
657,2021,Belle,64666502,0.153,74560476.81,4018313,4633114.889,60648189,69927361.92
658,2021,Ron's Gone Wrong,60692022,0.153,69977901.37,23009270,26529688.31,37682752,43448213.06
659,2021,Cloudy Mountain,58348836,0.153,67276207.91,0,0,58348836,67276207.91
660,2021,Avatar 2021 Re-release,57995770,0.153,66869122.81,0,0,57995770,66869122.81
661,2021,Nobody,57510518,0.153,66309627.25,27568035,31785944.36,29942483,34523682.9
662,2021,New Gods: Nezha Reborn,56088478,0.153,64670015.13,0,0,56088478,64670015.13
663,2021,Upcoming,54300000,0.153,62607900,0,0,54300000,62607900
664,2021,Don't Breathe 2,53785551,0.153,62014740.3,32712950,37718031.35,21072601,24296708.95
665,2021,Man in Love,52946097,0.153,61046849.84,0,0,52946097,61046849.84
666,2021,Break Through the Darkness,52700000,0.153,60763100,0,0,52700000,60763100
667,2021,Schemes in Antiques,51637422,0.153,59537947.57,36501,42085.653,51600921,59495861.91
668,2021,Luca,51074773,0.153,58889213.27,1324302,1526920.206,49750471,57362293.06
669,2021,Belfast,49158709,0.153,56679991.48,9250870,10666253.11,39907839,46013738.37
670,2021,My Hero Academia: World Heroes' Mission,46940541,0.153,54122443.77,12271658,14149221.67,34668883,39973222.1
671,2021,The French Dispatch,46333545,0.153,53422577.39,16124375,18591404.38,30209170,34831173.01
672,2021,In the Heights,45175167,0.153,52086967.55,29975167,34561367.55,15200000,17525600
673,2021,Love Will Tear Us Apart,45060290,0.153,51954514.37,0,0,45060290,51954514.37
674,2021,Spirit Untamed,42717215,0.153,49252948.9,17716215,20426795.9,25001000,28826153
675,2021,Resident Evil: Welcome to Raccoon City,41914915,0.153,48327897,17000612,19601705.64,24914303,28726191.36
676,2021,Spiral,40618920,0.153,46833614.76,23216862,26769041.89,17402058,20064572.87
677,2021,Snake Eyes,40064325,0.153,46194166.73,28264325,32588766.73,11800000,13605400
678,2021,Tokyo Revengers,39714624,0.153,45790961.47,0,0,39714624,45790961.47
679,2021,Nightmare Alley,39629195,0.153,45692461.84,11338107,13072837.37,28291088,32619624.46
680,2021,Nomadland,39458207,0.153,45495312.67,3700000,4266100,35758207,41229212.67
681,2021,King Richard,39429285,0.153,45461965.61,15129285,17444065.61,24300000,28017900
682,2021,Arashi Anniversary Tour 5 x 20 Film: Record of Memories,38052695,0.153,43874757.34,0,0,38052695,43874757.34
683,2021,The Yinyang Master,37690000,0.153,43456570,0,0,37690000,43456570
684,2021,Rurouni Kenshin: Final Chapter Part I - The Final,36964978,0.153,42620619.63,0,0,36964978,42620619.63
685,2021,The Door Lock,36100000,0.153,41623300,0,0,36100000,41623300
686,2021,We Made a Beautiful Bouquet,34975905,0.153,40327218.47,0,0,34975905,40327218.47
687,2021,Malignant,34891791,0.153,40230235.02,13391791,15440735.02,21500000,24789500
688,2021,Licorice Pizza,33274040,0.153,38364968.12,17318007,19967662.07,15956033,18397306.05
689,2021,Respect,32882823,0.153,37913894.92,24278399,27992994.05,8604424,9920900.872
690,2021,Big Red Envelope,32800000,0.153,37818400,0,0,32800000,37818400
691,2021,Masquerade Night,32287400,0.153,37227372.2,0,0,32287400,37227372.2
692,2021,Once Upon a Time in Hong Kong,32218874,0.153,37148361.72,0,0,32218874,37148361.72
693,2021,Home Sweet Home,32178677,0.153,37102014.58,0,0,32178677,37102014.58
694,2021,The Little Things,30842746,0.153,35561686.14,15342746,17690186.14,15500000,17871500
695,2021,The Unholy,30832137,0.153,35549453.96,15532137,17908553.96,15300000,17640900
696,2021,The Last Duel,30552111,0.153,35226583.98,10853945,12514598.59,19698166,22711985.4
697,2021,Escape from Mogadishu,29902716,0.153,34477831.55,346271,399250.463,29556445,34078581.09
698,2021,Master,28692230,0.153,33082141.19,0,0,28692230,33082141.19
699,2021,The Last Warrior: Root of Evil,28357398,0.153,32696079.89,0,0,28357398,32696079.89
700,2021,The Last Warrior: A Messenger of Darkness,27052365,0.153,31191376.85,0,0,27052365,31191376.85
701,2021,American Underdog,26514814,0.153,30571580.54,26514814,30571580.54,0,0
702,2021,Chaos Walking,26508132,0.153,30563876.2,13287908,15320957.92,13220224,15242918.27
703,2021,The Courier,26001227,0.153,29979414.73,6613432,7625287.096,19387795,22354127.64
704,2021,Spencer,25246967,0.153,29109752.95,7086632,8170886.696,18160335,20938866.26
705,2021,Parallel Mothers,23099858,0.153,26634136.27,2297501,2649018.653,20802357,23985117.62
706,2021,The Marksman,23076711,0.153,26607447.78,15566093,17947705.23,7510618,8659742.554
707,2021,99.9 Criminal Lawyer: The Movie,23055069,0.153,26582494.56,0,0,23055069,26582494.56
708,2021,Last Night in Soho,22957625,0.153,26470141.63,10127625,11677151.63,12830000,14792990
709,2021,The Day We Lit Up the Sky,22500000,0.153,25942500,0,0,22500000,25942500
710,2021,School of Magical Animals,21984454,0.153,25348075.46,288414,332541.342,21696040,25015534.12
711,2021,Kaamelott: First Installment,21979122,0.153,25341927.67,188000,216764,21791122,25125163.67
712,2021,After We Fell,21753705,0.153,25082021.87,2170750,2502874.75,19582955,22579147.12
713,2021,Rurouni Kenshin: Final Chapter Part II - The Beginning,21318560,0.153,24580299.68,0,0,21318560,24580299.68
714,2021,Wish Dragon,21120000,0.153,24351360,0,0,21120000,24351360
715,2021,Crayon Shin-chan: Shrouded in Mystery! The Flowers of Tenkazu Academy,20752104,0.153,23927175.91,0,0,20752104,23927175.91
716,2021,Stillwater,19754272,0.153,22776675.62,14465535,16678761.86,5288737,6097913.761
717,2021,The Wolf and the Lion,19510578,0.153,22495696.43,2072173,2389215.469,17438405,20106480.97
718,2021,Les Tuche 4,19259766,0.153,22206510.2,0,0,19259766,22206510.2
719,2021,Dear Evan Hansen,19133454,0.153,22060872.46,15002646,17298050.84,4130808,4762821.624
720,2021,Those Who Wish Me Dead,19107200,0.153,22030601.6,7407200,8540501.6,11700000,13490100
721,2021,The Pioneer,18900000,0.153,21791700,0,0,18900000,21791700
722,2021,The Green Knight,18887953,0.153,21777809.81,17173321,19800839.11,1714632,1976970.696
723,2021,Antlers,18867659,0.153,21754410.83,10619670,12244479.51,8247989,9509931.317
724,2021,Sinkhole,18816801,0.153,21695771.55,0,0,18816801,21695771.55
725,2021,Mobile Suit Gundam: Hathaway,18731309,0.153,21597199.28,0,0,18731309,21597199.28
726,2021,The Stronghold,18066143,0.153,20830262.88,0,0,18066143,20830262.88
727,2021,"Dad, I'm Sorry",17480489,0.153,20155003.82,350000,403550,17130489,19751453.82
728,2021,Gintama: The Final,17252960,0.153,19892662.88,0,0,17252960,19892662.88
729,2021,Railway Heroes,17223704,0.153,19858930.71,0,0,17223704,19858930.71
730,2021,Your Turn to Kill,16511822,0.153,19038130.77,0,0,16511822,19038130.77
731,2021,Cry Macho,16510734,0.153,19036876.3,10310734,11888276.3,6200000,7148600
732,2021,Reminiscence,16400193,0.153,18909422.53,3900193,4496922.529,12500000,14412500
733,2021,Legend No. 17,16096860,0.153,18559679.58,0,0,16096860,18559679.58
734,2021,Upon the Magic Roads,15990882,0.153,18437486.95,0,0,15990882,18437486.95
735,2021,Harry Potter and the Sorcerer's Stone 2021 Re-release,15591681,0.153,17977208.19,799342,921641.326,14604379,16838848.99
736,2021,The Dry,15576286,0.153,17959457.76,364237,419965.261,15212049,17539492.5
737,2021,The Night House,15437703,0.153,17799671.56,7100581,8186969.893,8337122,9612701.666
738,2021,Drive My Car,15364572,0.153,17715351.52,2352240,2712132.72,13012332,15003218.8
739,2021,Minari,15288578,0.153,17627730.43,3110580,3586498.74,12177998,14041231.69
740,2021,Something About Love,15204017,0.153,17530231.6,0,0,15204017,17530231.6
741,2021,Anita,15017470,0.153,17315142.91,556632,641796.696,14460838,16673346.21
742,2021,The Tomorrow War,14400000,0.153,16603200,0,0,14400000,16603200
743,2021,And So the Baton Is Passed,14368469,0.153,16566844.76,0,0,14368469,16566844.76
744,2021,Sword Art Online: Progressive - Aria of a Starless Night,14032747,0.153,16179757.29,1050000,1210650,12982747,14969107.29
745,2021,Christmas with the Chosen: The Messengers,13728000,0.153,15828384,13728000,15828384,0,0
746,2021,Eiffel,13649605,0.153,15737994.57,444814,512870.542,13204791,15225124.02
747,2021,OSS 117: From Africa with Love,13457801,0.153,15516844.55,0,0,13457801,15516844.55
748,2021,Hostage: Missing Celebrity,13174292,0.153,15189958.68,0,0,13174292,15189958.68
749,2021,Vakeel Saab,13056490,0.153,15054132.97,0,0,13056490,15054132.97
750,2021,The Many Saints of Newark,13037403,0.153,15032125.66,8237403,9497725.659,4800000,5534400
751,2021,The Monkey King: Reborn,13017088,0.153,15008702.46,0,0,13017088,15008702.46
752,2021,No Escapes,12916151,0.153,14892322.1,0,0,12916151,14892322.1
753,2021,The Bodin's in the Land of Smile,12872253,0.153,14841707.71,0,0,12872253,14841707.71
754,2021,The Worst Person in the World,12687507,0.153,14628695.57,3034775,3499095.575,9652732,11129600
755,2021,Character,12628017,0.153,14560103.6,0,0,12628017,14560103.6
756,2021,On the Line,12522284,0.153,14438193.45,0,0,12522284,14438193.45
757,2021,On Your Mark,12100000,0.153,13951300,0,0,12100000,13951300
758,2021,Stand by Me,11900000,0.153,13720700,0,0,11900000,13720700
759,2021,The Fable: The Killer Who Doesn't Kill,11325545,0.153,13058353.39,0,0,11325545,13058353.39
760,2021,What Did You Eat Yesterday?,11320893,0.153,13052989.63,0,0,11320893,13052989.63
761,2021,Aline,11149943,0.153,12855884.28,667815,769990.695,10482128,12085893.58
762,2021,Krack,10442916,0.153,12040682.15,0,0,10442916,12040682.15
763,2021,The Last Warrior,10363914,0.153,11949592.84,0,0,10363914,11949592.84
764,2021,Kaiserschmarrndrama,10357720,0.153,11942451.16,0,0,10357720,11942451.16
765,2021,"Caution, Hazardous Wife: The Movie",10356359,0.153,11940881.93,0,0,10356359,11940881.93
766,2021,Detective Conan: The Scarlet Alibi,10308627,0.153,11885846.93,0,0,10308627,11885846.93
767,2021,Never Stop,10224935,0.153,11789350.06,0,0,10224935,11789350.06
768,2021,Ainbo,10172403,0.153,11728780.66,0,0,10172403,11728780.66
769,2021,Eiga Sumikkogurashi: Aoi tsukiyo no mahô no ko,9742510,0.153,11233114.03,0,0,9742510,11233114.03
770,2021,Black Box,9738741,0.153,11228768.37,0,0,9738741,11228768.37
771,2021,The Soul,9600000,0.153,11068800,0,0,9600000,11068800
772,2021,¡A todo tren! Destino Asturias,9544171,0.153,11004429.16,0,0,9544171,11004429.16
773,2021,Baragaki: Unbroken Samurai,9481437,0.153,10932096.86,0,0,9481437,10932096.86
774,2021,Dad,9267397,0.153,10685308.74,0,0,9267397,10685308.74
775,2021,The Lord of the Rings: The Fellowship of the Ring 2021 Re-release,8990599,0.153,10366160.65,0,0,8377569,9659337.057
776,2021,All About My Mother,8900000,0.153,10261700,0,0,8900000,10261700
777,2021,Moonbound,8864412,0.153,10220667.04,0,0,8864412,10220667.04
778,2021,The Eleventh Chapter,8844997,0.153,10198281.54,0,0,8844997,10198281.54
779,2021,The Medium,8826689,0.153,10177172.42,0,0,8826689,10177172.42
780,2021,The Vault,8803864,0.153,10150855.19,0,0,8803864,10150855.19
781,2021,Kaguya-sama: Love Is War,8794981,0.153,10140613.09,0,0,8794981,10140613.09
782,2021,The Protégé,8737253,0.153,10074052.71,7446823,8586186.919,1290430,1487865.79
783,2021,Lost Illusions,8635184,0.153,9956367.152,126391,145728.823,8508793,9810638.329
784,2021,Agent Backkom: King's Bear,8578734,0.153,9891280.302,0,0,8578734,9891280.302
785,2021,Pil's Adventures,8567345,0.153,9878148.785,0,0,8567345,9878148.785
786,2021,Honey Lemon Soda,8441488,0.153,9733035.664,0,0,8441488,9733035.664
787,2021,Delicious,8371523,0.153,9652366.019,0,0,8371523,9652366.019
788,2021,I Don't Have Any Money Left in My Retirement Account,8204616,0.153,9459922.248,0,0,8204616,9459922.248
789,2021,Girls to Buy,8177284,0.153,9428408.452,0,0,8177284,9428408.452
790,2021,Green Snake,8170000,0.153,9420010,0,0,8170000,9420010
791,2021,New Happy Dad and Son 4,8070000,0.153,9304710,0,0,8070000,9304710
792,2021,Sunny Sisters,7880000,0.153,9085640,0,0,7880000,9085640
793,2021,Contra,7762797,0.153,8950504.941,0,0,7762797,8950504.941
794,2021,Hard Hit,7658021,0.153,8829698.213,0,0,7658021,8829698.213
795,2021,Little Canned Men,7600000,0.153,8762800,0,0,7600000,8762800
796,2021,Pushpa: The Rise - Part 1,7592374,0.153,8754007.222,1320000,1521960,6272374,7232047.222
797,2021,The Mauritanian,7527030,0.153,8678665.59,836536,964526.008,6690494,7714139.582
798,2021,The Ice Road,7502846,0.153,8650781.438,0,0,7502846,8650781.438
799,2021,Judas and the Black Messiah,7478009,0.153,8622144.377,5478009,6316144.377,2000000,2306000
800,2021,Love Letter 2021 Re-release,7400000,0.153,8532200,0,0,7400000,8532200
801,2021,Signal: The Movie,7388603,0.153,8519059.259,0,0,7388603,8519059.259
802,2022,Avatar: The Way of Water,2320250281,0.067,2475707050,684075767,729908843.4,1636174514,1745798206
803,2022,Top Gun: Maverick,1495696292,0.067,1595907944,718732821,766887920,776963471,829020023.6
804,2022,Jurassic World Dominion,1001978080,0.067,1069110611,376851080,402100102.4,625127000,667010509
805,2022,Doctor Strange in the Multiverse of Madness,955775804,0.067,1019812783,411331607,438890824.7,544444197,580921958.2
806,2022,Minions: The Rise of Gru,940203765,0.067,1003197417,370270765,395078906.3,569933000,608118511
807,2022,Black Panther: Wakanda Forever,859208836,0.067,916775828,453829060,484235607,405379776,432540221
808,2022,The Batman,772245583,0.067,823986037.1,369345583,394091737.1,402900000,429894300
809,2022,Thor: Love and Thunder,760928081,0.067,811910262.4,343256830,366255037.6,417671251,445655224.8
810,2022,Water Gate Bridge,626571697,0.067,668552000.7,117294,125152.698,626454403,668426848
811,2022,Puss in Boots: The Last Wish,481705474,0.067,513979740.8,186090535,198558600.8,295614939,315421139.9
812,2022,Moon Man,460237662,0.067,491073585.4,0,0,460237662,491073585.4
813,2022,Fantastic Beasts: The Secrets of Dumbledore,407150844,0.067,434429950.5,95850844,102272850.5,311300000,332157100
814,2022,Uncharted,407141258,0.067,434419722.3,148648820,158608290.9,258492438,275811431.3
815,2022,Sonic the Hedgehog 2,405421518,0.067,432584759.7,190872904,203661388.6,214548614,228923371.1
816,2022,Black Adam,393452111,0.067,419813402.4,168152111,179418302.4,225300000,240395100
817,2022,Elvis,287740048,0.067,307018631.2,151040048,161159731.2,136700000,145858900
818,2022,The Bad Guys,250387888,0.067,267163876.5,97459240,103989009.1,152928648,163174867.4
819,2022,Bullet Train,239268602,0.067,255299598.3,103368602,110294298.3,135900000,145005300
820,2022,Lightyear,226425420,0.067,241595923.1,118307188,126233769.6,108118232,115362153.5
821,2022,Smile,217408513,0.067,231974883.4,105935048,113032696.2,111473465,118942187.2
822,2022,Too Cool to Kill,217254604,0.067,231810662.5,185882,198336.094,217068722,231612326.4
823,2022,Nice View,211019042,0.067,225157317.8,0,0,211019042,225157317.8
824,2022,DC League of Super-Pets,207557117,0.067,221463443.8,93657117,99932143.84,113900000,121531300
825,2022,The Lost City,192907684,0.067,205832498.8,105344029,112402078.9,87563655,93430419.89
826,2022,M3GAN,180089109,0.067,192155079.3,95159005,101534658.3,84930104,90620420.97
827,2022,One Piece Film: Red,171319579,0.067,182797990.8,12775324,13631270.71,158544255,169166720.1
828,2022,Nope,171235592,0.067,182708376.7,123277080,131536644.4,47958512,51171732.3
829,2022,Ticket to Paradise,168770985,0.067,180078641,68275985,72850476,100495000,107228165
830,2022,Morbius,167460961,0.067,178680845.4,73865530,78814520.51,93595431,99866324.88
831,2022,RRR,165955146,0.067,177074140.8,14500000,15471500,151455146,161602640.8
832,2022,The Black Phone,161440742,0.067,172257271.7,90123230,96161486.41,71317512,76095785.3
833,2022,The First Slam Dunk,152918859,0.067,163164422.6,1291869,1378424.223,151626990,161785998.3
834,2022,Where the Crawdads Sing,144353965,0.067,154025680.7,90230760,96276220.92,54123205,57749459.74
835,2022,Everything Everywhere All at Once,139405704,0.067,148745886.2,77191785,82363634.6,62213919,66382251.57
836,2022,Scream,137743924,0.067,146972766.9,81641405,87111379.14,56102519,59861387.77
837,2022,Death on the Nile,137307235,0.067,146506819.7,45630104,48687320.97,91677131,97819498.78
838,2022,Suzume,132181655,0.067,141037825.9,10932037,11664483.48,121249618,129373342.4
839,2022,A Man Called Otto,113190218,0.067,120773962.6,64267657,68573590.02,48922561,52200372.59
840,2022,"Lyle, Lyle, Crocodile",110999085,0.067,118436023.7,46888441,50029966.55,64110644,68406057.15
841,2022,Halloween Ends,104374176,0.067,111367245.8,64079860,68373210.62,40294316,42994035.17
842,2022,The Roundup,101166707,0.067,107944876.4,812859,867320.553,100353848,107077555.8
843,2022,The Woman King,97562514,0.067,104099202.4,67328130,71839114.71,30234384,32260087.73
844,2022,Downton Abbey: A New Era,92651384,0.067,98859026.73,44141550,47099033.85,48509834,51759992.88
845,2022,K.G.F: Chapter 2,89123940,0.067,95095243.98,2874000,3066558,86249940,92028685.98
846,2022,Don't Worry Darling,87609403,0.067,93479233,45309403,48345133,42300000,45134100
847,2022,Dragon Ball Super: Super Hero,86562140,0.067,92361803.38,38112140,40665653.38,48450000,51696150
848,2022,Dog,84485461,0.067,90145986.89,61778069,65917199.62,22707392,24228787.26
849,2022,Jackass Forever,80563999,0.067,85961786.93,57743451,61612262.22,22820548,24349524.72
850,2022,The Menu,79628200,0.067,84963289.4,38501125,41080700.38,41127075,43882589.03
851,2022,Chebi: My Fluffy Friend,77609926,0.067,82809791.04,0,0,77609926,82809791.04
852,2022,Avatar 2022 Re-release,76012917,0.067,81105782.44,24714024,26369863.61,51298893,54735918.83
853,2022,Violent Night,76004405,0.067,81096700.14,50057405,53411251.14,25947000,27685449
854,2022,Strange World,73621640,0.067,78554289.88,37968963,40512883.52,35652677,38041406.36
855,2022,Detective Conan: The Bride of Halloween,72699093,0.067,77569932.23,0,0,72699093,77569932.23
856,2022,The Northman,69633110,0.067,74298528.37,34233110,36526728.37,35400000,37771800
857,2022,Moonfall,67319703,0.067,71830123.1,19060660,20337724.22,48234703,51466428.1
858,2022,Babylon,63562440,0.067,67821123.48,15351455,16380002.49,48210985,51441121
859,2022,Whitney Houston: I Wanna Dance with Somebody,59806881,0.067,63813942.03,23708080,25296521.36,36098801,38517420.67
860,2022,Beast,59095809,0.067,63055228.2,31846530,33980247.51,27249279,29074980.69
861,2022,The Whale,57615635,0.067,61475882.55,17463630,18633693.21,39563064,42213789.29
862,2022,Hansan: Rising Dragon,57490985,0.067,61342881,865888,923902.496,56625097,60418978.5
863,2022,Confidential Assignment 2: International,54486330,0.067,58136914.11,0,0,54486330,58136914.11
864,2022,Ambulance,52303589,0.067,55807929.46,22781115,24307449.71,29522474,31500479.76
865,2022,Marry Me,50541093,0.067,53927346.23,22438180,23941538.06,28102913,29985808.17
866,2022,Brahmastra Part One: Shiva,50164785,0.067,53525825.6,7839108,8364328.236,42325677,45161497.36
867,2022,The Banshees of Inisherin,49262687,0.067,52563287.03,10582266,11291277.82,38680421,41272009.21
868,2022,The Fabelmans,45647323,0.067,48705693.64,17348945,18511324.32,28298378,30194369.33
869,2022,Barbarian,45352337,0.067,48390943.58,40842944,43579421.25,4509393,4811522.331
870,2022,Prey for the Devil,44658929,0.067,47651077.24,19802293,21129046.63,24856636,26522030.61
871,2022,Paws of Fury: The Legend of Hank,42431358,0.067,45274258.99,17811382,19004744.59,24619976,26269514.39
872,2022,The Invitation,38036130,0.067,40584550.71,25100080,26781785.36,12936050,13802765.35
873,2022,Orphan: First Kill,37083743,0.067,39568353.78,5413227,5775913.209,31670516,33792440.57
874,2022,Matilda: The Musical,35617120,0.067,38003467.04,0,0,35617120,38003467.04
875,2022,Kingdom II: Harukanaru Daichi e,34963395,0.067,37305942.47,0,0,34963395,37305942.47
876,2022,The Bob's Burgers Movie,34148750,0.067,36436716.25,31933830,34073396.61,2214920,2363319.64
877,2022,Skyfall 2021 Re-release,33943406,0.067,36217614.2,0,0,33910282,36182270.89
878,2022,Hunt,33821338,0.067,36087367.65,25994,27735.598,33795344,36059632.05
879,2022,Tad the Lost Explorer and the Emerald Tablet,32849430,0.067,35050341.81,67599,72128.133,32781831,34978213.68
880,2022,BTS Permission to Dance on Stage - Seoul: Live Viewing,32600000,0.067,34784200,6840000,7298280,25760000,27485920
881,2022,Shin Ultraman,32137136,0.067,34290324.11,601490,641789.83,31535646,33648534.28
882,2022,Amsterdam,31245810,0.067,33339279.27,14947969,15949482.92,16297841,17389796.35
883,2022,Mrs. Harris Goes to Paris,30947403,0.067,33020879,10433915,11132987.31,20513488,21887891.7
884,2022,Vikram,29837637,0.067,31836758.68,1770000,1888590,28067637,29948168.68
885,2022,The Unbearable Weight of Massive Talent,29116320,0.067,31067113.44,20300157,21660267.52,8816163,9406845.921
886,2022,Tár,29048571,0.067,30994825.26,6773650,7227484.55,22274921,23767340.71
887,2022,Serial (Bad) Weddings 3,27832384,0.067,29697153.73,0,0,27832384,29697153.73
888,2022,The 355,27827745,0.067,29692203.92,14570455,15546675.49,13257290,14145528.43
889,2022,The Night Owl,26719364,0.067,28509561.39,0,0,26719364,28509561.39
890,2022,Triangle of Sadness,26214659,0.067,27971041.15,4608096,4916838.432,21606563,23054202.72
891,2022,Calendar Girls,25433615,0.067,27137667.21,0,0,25433615,27137667.21
892,2022,The Last 10 Years,24940914,0.067,26611955.24,0,0,24940914,26611955.24
893,2022,The Kashmir Files,24821898,0.067,26484965.17,1485000,1584495,23336898,24900470.17
894,2022,Hero,24392492,0.067,26026788.96,0,0,24392492,26026788.96
895,2022,The Confidence Man JP: Episode of the Hero,23214581,0.067,24769957.93,0,0,23214581,24769957.93
896,2022,The Witch: Part 2 - The Other One,23068596,0.067,24614191.93,143723,153352.441,22924873,24460839.49
897,2022,Decision to Leave,22581906,0.067,24094893.7,2179864,2325914.888,20402042,21768978.81
898,2022,6/45,22263336,0.067,23754979.51,0,0,22263336,23754979.51
899,2022,Doraemon the Movie: Nobita's Little Star Wars 2021,22044058,0.067,23521009.89,0,0,22044058,23521009.89
900,2022,See How They Run,21966634,0.067,23438398.48,9586237,10228514.88,12380397,13209883.6
901,2022,Ponniyin Selvan: Part I,21888295,0.067,23354810.77,4282000,4568894,17606295,18785916.77
902,2022,Monster,21857035,0.067,23321456.35,434585,463702.195,21422450,22857754.15
903,2022,Devotion,21768133,0.067,23226597.91,20511938,21886237.85,1256195,1340360.065
904,2022,Silent Parade,21723595,0.067,23179075.87,0,0,21723595,23179075.87
905,2022,Father Stu,21592379,0.067,23039068.39,20884796,22284077.33,707583,754991.061
906,2022,Turning Red,21521622,0.067,22963570.67,1399001,1492734.067,20122621,21470836.61
907,2022,Emergency Declaration,21400327,0.067,22834148.91,412196,439813.132,20988131,22394335.78
908,2022,The Amazing Maurice,21115581,0.067,22530324.93,4303645,4591989.215,16811936,17938335.71
909,2022,Crayon Shin-chan: Mononoke Ninja Chinpuden,20617005,0.067,21998344.34,0,0,20617005,21998344.34
910,2022,Three Thousand Years of Longing,20282422,0.067,21641344.27,8286741,8841952.647,11995681,12799391.63
911,2022,School of Magical Animals 2,19576206,0.067,20887811.8,0,0,19576206,20887811.8
912,2022,After Ever Happy,19238073,0.067,20527023.89,1072750,1144624.25,18165323,19382399.64
913,2022,Simone: Woman of the Century,19167164,0.067,20451363.99,0,0,19167164,20451363.99
914,2022,Beast,18911959,0.067,20179060.25,0,0,18911959,20179060.25
915,2022,Broker,18851416,0.067,20114460.87,1046899,1117041.233,17804517,18997419.64
916,2022,Godfather,18737287,0.067,19992685.23,0,0,18737287,19992685.23
917,2022,Bhool Bhulaiyaa 2,18307258,0.067,19533844.29,0,0,18307258,19533844.29
918,2022,November,18200422,0.067,19419850.27,0,0,18200422,19419850.27
919,2022,Fragments of the Last Will,17954691,0.067,19157655.3,0,0,17954691,19157655.3
920,2022,The Quintessential Quintuplets Movie,17506171,0.067,18679084.46,502000,535634,17004171,18143450.46
921,2022,Fall,17363261,0.067,18526599.49,7240521,7725635.907,10122740,10800963.58
922,2022,Even If This Love Disappears from the World Tonight,16848229,0.067,17977060.34,0,0,16848229,17977060.34
923,2022,Wunderschön,16719291,0.067,17839483.5,0,0,16719291,17839483.5
924,2022,Father There Is Only One 3,16401315,0.067,17500203.11,0,0,16401315,17500203.11
925,2022,Dr. Coto's Clinic,16062841,0.067,17139051.35,0,0,16062841,17139051.35
926,2022,Radhe Shyam,15954804,0.067,17023775.87,1860000,1984620,14094804,15039155.87
927,2022,Blacklight,15902207,0.067,16967654.87,9591094,10233697.3,6311113,6733957.571
928,2022,Operation Mincemeat,15710164,0.067,16762744.99,0,0,15710164,16762744.99
929,2022,Maison de retraite,15570823,0.067,16614068.14,0,0,15570823,16614068.14
930,2022,"Utapri Movie 2, Uta No Prince-Sama Maji Love Starish Tours Movie",15569229,0.067,16612367.34,0,0,15569229,16612367.34
931,2022,Bheemla Nayak,15243922,0.067,16265264.77,0,0,15243922,16265264.77
932,2022,Bones and All,15234907,0.067,16255645.77,7834907,8359845.769,7400000,7895800
933,2022,Terrifier 2,15065239,0.067,16074610.01,10640105,11352992.04,4425134,4721617.978
934,2022,Firestarter,15039250,0.067,16046879.75,9739250,10391779.75,5300000,5655100
935,2022,The Wolf of Wall Street 2022 Re-release,15038738,0.067,16046333.45,0,0,14877539,15874334.11
936,2022,Bros,14781867,0.067,15772252.09,11628165,12407252.06,3153702,3365000.034
937,2022,Superwho?,14770359,0.067,15759973.05,0,0,14770359,15759973.05
938,2022,X,14740889,0.067,15728528.56,11765309,12553584.7,2975580,3174943.86
939,2022,The Chosen Season 3: Episode 1 & 2,14679613,0.067,15663147.07,14612089,15591098.96,67524,72048.108
940,2022,The Duke,14233027,0.067,15186639.81,1526970,1629276.99,12700247,13551163.55
941,2022,Sarkaru Vaari Paata,14199018,0.067,15150352.21,0,0,14199018,15150352.21
942,2022,She Said,13944212,0.067,14878474.2,5825995,6216336.665,8118217,8662137.539
943,2022,Bodies Bodies Bodies,13929670,0.067,14862957.89,11446602,12213524.33,2483068,2649433.556
944,2022,Memory,13897255,0.067,14828371.09,7329043,7820088.881,6568212,7008282.204
945,2022,The Legend of Maula Jatt,13842815,0.067,14770283.61,5016493,5352598.031,8826322,9417685.574
946,2022,Glass Onion,13280000,0.067,14169760,13280000,14169760,0,0
947,2022,Valimai,13276393,0.067,14165911.33,0,0,13276393,14165911.33
948,2022,Moonage Daydream,13095781,0.067,13973198.33,4218925,4501592.975,8876856,9471605.352
949,2022,Easter Sunday,13074255,0.067,13950230.09,13013690,13885607.23,60565,64622.855
950,2022,Living,12377310,0.067,13206589.77,3038113,3241666.571,9339197,9964923.199
951,2022,Guglhupfgeschwader,12307072,0.067,13131645.82,0,0,12307072,13131645.82
952,2022,Laal Singh Chaddha,12093536,0.067,12903802.91,3401324,3629212.708,8692212,9274590.204
953,2022,Alienoid,12067556,0.067,12876082.25,168309,179585.703,11899247,12696496.55
954,2022,That Time I Got Reincarnated as a Slime the Movie: Scarlet Bond,11631738,0.067,12411064.45,1588491,1694919.897,10043247,10716144.55
955,2022,Till,11498884,0.067,12269309.23,9000202,9603215.534,2498682,2666093.694
956,2022,Jug Jugg Jeeyo,11467726,0.067,12236063.64,1033000,1102211,10434726,11133852.64
957,2022,Empire of Light,11395604,0.067,12159109.47,1177577,1256474.659,10218027,10902634.81
958,2022,The Eight Mountains,11374178,0.067,12136247.93,302456,322720.552,11071722,11813527.37
959,2022,Bergen,11325405,0.067,12084207.14,0,0,11325405,12084207.14
960,2022,Rise,11252331,0.067,12006237.18,0,0,11252331,12006237.18
961,2022,Men,11152071,0.067,11899259.76,7587853,8096239.151,3564218,3803020.606
962,2022,Chickenhare and the Hamster of Darkness,10885116,0.067,11614418.77,0,0,10885116,11614418.77
963,2022,Warriors of Future,10490328,0.067,11193179.98,0,0,10490328,11193179.98
964,2022,Jurassic Park 2022 Re-release,10380250,0.067,11075726.75,0,0,10374018,11069077.21
965,2022,Land of Legends,10357479,0.067,11051430.09,0,0,10357479,11051430.09
966,2022,The Pirates: The Last Royal Treasure,10258331,0.067,10945639.18,0,0,10258331,10945639.18
967,2022,Vaillante,10143170,0.067,10822762.39,0,0,10143170,10822762.39
968,2022,Table for Six,10138355,0.067,10817624.79,0,0,10138355,10817624.79
969,2022,The Beasts,10067896,0.067,10742445.03,46105,49194.035,10021791,10693251
970,2022,Smack Dab Kakha,9995945,0.067,10665673.32,0,0,9995945,10665673.32
971,2022,F3: Fun and Frustration,9849193,0.067,10509088.93,1195000,1275065,8654193,9234023.931
972,2022,"Good Luck to You, Leo Grande",9795364,0.067,10451653.39,0,0,9795364,10451653.39
973,2022,Pearl,9747742,0.067,10400840.71,9423445,10054815.82,324297,346024.899
974,2022,Rheingold,9699701,0.067,10349580.97,0,0,9699701,10349580.97
975,2022,Spider-Man: No Way Home 2022 Re-release,9613518,0.067,10257623.71,9321593,9946139.731,291925,311483.975
976,2022,Redeeming Love,9464198,0.067,10098299.27,9214020,9831359.34,250178,266939.926
977,2022,Women Talking,9276103,0.067,9897601.901,5456531,5822118.577,3819572,4075483.324
978,2022,Sword Art Online the Movie: Progressive - Scherzo of Deep Night,9071701,0.067,9679504.967,0,0,9071701,9679504.967
979,2022,Samrat Prithviraj,8568339,0.067,9142417.713,0,0,8568339,9142417.713
980,2022,Aftersun,8459155,0.067,9025918.385,1658790,1769928.93,6800365,7255989.455
981,2022,Life Is Beautiful,8458639,0.067,9025367.813,0,0,8458639,9025367.813
982,2022,Yolki 9,8385030,0.067,8946827.01,0,0,8385030,8946827.01
983,2022,Don,8287406,0.067,8842662.202,0,0,8287406,8842662.202
984,2022,Shotgun Wedding,8277788,0.067,8832399.796,0,0,8277788,8832399.796
985,2022,Vikram Vedha,8234166,0.067,8785855.122,1589362,1695849.254,6644804,7090005.868
986,2022,Re/Member,8166175,0.067,8713308.725,0,0,8166175,8713308.725
987,2022,Rabbit Academy: Mission Eggpossible,8103825,0.067,8646781.275,0,0,8103825,8646781.275
988,2022,Acharya,8048175,0.067,8587402.725,832000,887744,7216175,7699658.725
989,2022,Il grande giorno,8021940,0.067,8559409.98,0,0,8021940,8559409.98
990,2022,The Tatta's,8000956,0.067,8537020.052,0,0,8000956,8537020.052
991,2022,Ducobu 4 President,7858171,0.067,8384668.457,0,0,7858171,8384668.457
992,2022,Phases of the Moon,7564756,0.067,8071594.652,0,0,7564756,8071594.652
993,2022,777 Charlie,7523995,0.067,8028102.665,0,0,7523995,8028102.665
994,2022,Bachchhan Paandey,7387882,0.067,7882870.094,0,0,7387882,7882870.094
995,2022,Lesson in Murder,7348964,0.067,7841344.588,0,0,7348964,7841344.588
996,2022,Family Affairs,7330755,0.067,7821915.585,0,0,7330755,7821915.585
997,2022,Listy do M. 5,7328061,0.067,7819041.087,0,0,7328061,7819041.087
998,2022,Laid-Back Camp Movie,7317913,0.067,7808213.171,0,0,7317913,7808213.171
999,2022,Osomatsusan the Movie 2022 Re-release,7297522,0.067,7786455.974,0,0,7297522,7786455.974
1000,2022,The New Toy,7295051,0.067,7783819.417,0,0,7295051,7783819.417
1001,2022,Finnick,7257776,0.067,7744046.992,0,0,7257776,7744046.992
1002,2023,Barbie,1445638421,0.025,1481779382,636238421,652144381.5,809400000,829635000
1003,2023,The Super Mario Bros. Movie,1362052250,0.025,1396103556,574934330,589307688.3,787117920,806795868
1004,2023,Oppenheimer,971337540,0.025,995620978.5,329862540,338109103.5,641475000,657511875
1005,2023,Guardians of the Galaxy Vol. 3,845555777,0.025,866694671.4,358995815,367970710.4,486559962,498723961.1
1006,2023,Fast X,704875015,0.025,722496890.4,146126015,149779165.4,558749000,572717725
1007,2023,Spider-Man: Across the Spider-Verse,690615475,0.025,707880861.9,381311319,390844102,309304156,317036759.9
1008,2023,Wonka,632302312,0.025,648109869.8,218402312,223862369.8,413900000,424247500
1009,2023,The Little Mermaid,569626289,0.025,583866946.2,298172056,305626357.4,271454233,278240588.8
1010,2023,Mission: Impossible - Dead Reckoning Part One,567535383,0.025,581723767.6,172135383,176438767.6,395400000,405285000
1011,2023,Elemental,496444308,0.025,508855415.7,154426697,158287364.4,342017611,350568051.3
1012,2023,Ant-Man and the Wasp: Quantumania,476071180,0.025,487972959.5,214504909,219867531.7,261566271,268105427.8
1013,2023,John Wick: Chapter 4,440157245,0.025,451161176.1,187131806,191810101.2,253025439,259351075
1014,2023,Transformers: Rise of the Beasts,438966392,0.025,449940551.8,157066392,160993051.8,281900000,288947500
1015,2023,Aquaman and the Lost Kingdom,434381226,0.025,445240756.7,124481226,127593256.7,309900000,317647500
1016,2023,Meg 2: The Trench,397700317,0.025,407642824.9,82600317,84665324.93,315100000,322977500
1017,2023,Indiana Jones and the Dial of Destiny,383963057,0.025,393562133.4,174480468,178842479.7,209482589,214719653.7
1018,2023,The Hunger Games: The Ballad of Songbirds & Snakes,337371917,0.025,345806214.9,166350594,170509358.9,171021323,175296856.1
1019,2023,Migration,295556285,0.025,302945192.1,127306285,130488942.1,168250000,172456250
1020,2023,Five Nights at Freddy's,291493620,0.025,298780960.5,137275620,140707510.5,154218000,158073450
1021,2023,Creed III,276148615,0.025,283052330.4,156248615,160154830.4,119900000,122897500
1022,2023,The Flash,271333313,0.025,278116645.8,108133313,110836645.8,163200000,167280000
1023,2023,The Nun II,269467073,0.025,276203749.8,86267073,88423749.83,183200000,187780000
1024,2023,Taylor Swift: The Eras Tour,261656269,0.025,268197675.7,180756269,185275175.7,80900000,82922500
1025,2023,Wish,254876117,0.025,261248019.9,63973821,65573166.53,190902296,195674853.4
1026,2023,Sound of Freedom,250570396,0.025,256834655.9,184178046,188782497.2,66392350,68052158.75
1027,2023,Napoleon,221036479,0.025,226562391,61524375,63062484.38,159512104,163499906.6
1028,2023,Anyone But You,218982046,0.025,224456597.2,88319668,90527659.7,130662378,133928937.5
1029,2023,Dungeons & Dragons: Honor Among Thieves,208177026,0.025,213381451.7,93277026,95608951.65,114900000,117772500
1030,2023,Trolls Band Together,207731833,0.025,212925128.8,102996915,105571837.9,104734918,107353291
1031,2023,The Marvels,206124109,0.025,211277211.7,84500223,86612728.58,121623886,124664483.2
1032,2023,PAW Patrol: The Mighty Movie,202231360,0.025,207287144,65231360,66862144,137000000,140425000
1033,2023,The Equalizer 3,191067560,0.025,195844249,92373751,94683094.78,98693809,101161154.2
1034,2023,Insidious: The Red Door,189086877,0.025,193814048.9,82156962,84210886.05,106929915,109603162.9
1035,2023,Teenage Mutant Ninja Turtles: Mutant Mayhem,180513586,0.025,185026425.7,118613586,121578925.7,61900000,63447500
1036,2023,The Boy and the Heron,173267711,0.025,177599403.8,46781608,47951148.2,126486103,129648255.6
1037,2023,Scream VI,168961389,0.025,173185423.7,108161389,110865423.7,60800000,62320000
1038,2023,Killers of the Flower Moon,157026901,0.025,160952573.5,68026901,69727573.53,89000000,91225000
1039,2023,Evil Dead Rise,147033054,0.025,150708880.4,67233054,68913880.35,79800000,81795000
1040,2023,The Exorcist: Believer,136284218,0.025,139691323.5,65537395,67175829.88,70746823,72515493.58
1041,2023,Shazam! Fury of the Gods,134038006,0.025,137388956.2,57638006,59078956.15,76400000,78310000
1042,2023,Blue Beetle,130788072,0.025,134057773.8,72488072,74300273.8,58300000,59757500
1043,2023,A Haunting in Venice,122290456,0.025,125347717.4,42471412,43533197.3,79819044,81814520.1
1044,2023,Gran Turismo,122101055,0.025,125153581.4,44428554,45539267.85,77672501,79614313.53
1045,2023,Haunted Mansion,117449790,0.025,120386034.8,67653287,69344619.18,49796503,51041415.58
1046,2023,Poor Things,117022347,0.025,119947905.7,34553225,35417055.63,82469122,84530850.05
1047,2023,Godzilla Minus One,115869952,0.025,118766700.8,56418793,57829262.83,59451159,60937437.98
1048,2023,Pathaan,112583450,0.025,115398036.3,17487476,17924662.9,95095974,97473373.35
1049,2023,Saw X,111823047,0.025,114618623.2,53607898,54948095.45,58215149,59670527.73
1050,2023,Detective Conan: Black Iron Submarine,106771806,0.025,109441101.2,0,0,106771806,109441101.2
1051,2023,The Creator,104272136,0.025,106878939.4,40774679,41794045.98,63497457,65084893.43
1052,2023,12.12: The Day,97476565,0.025,99913479.13,0,0,97476565,99913479.13
1053,2023,Animal,92870227,0.025,95191982.68,15004482,15379594.05,77865745,79812388.63
1054,2023,Talk to Me,92181735,0.025,94486278.38,48299436,49506921.9,43882299,44979356.48
1055,2023,Air,90060106,0.025,92311608.65,52460106,53771608.65,37600000,38540000
1056,2023,Cocaine Bear,88314672,0.025,90522538.8,64670240,66286996,23644432,24235542.8
1057,2023,No Hard Feelings,87256407,0.025,89437817.18,50452282,51713589.05,36804125,37724228.13
1058,2023,The Roundup: No Way Out,83410298,0.025,85495555.45,909411,932146.275,82500887,84563409.18
1059,2023,The Pope's Exorcist,76987621,0.025,78912311.53,20009380,20509614.5,56978241,58402697.03
1060,2023,Plane,74515586,0.025,76378475.65,32111181,32913960.53,42404405,43464515.13
1061,2023,Titanic 25 Year Anniversary,70157472,0.025,71911408.8,15033795,15409639.88,55123677,56501768.93
1062,2023,The Color Purple,67519191,0.025,69207170.78,60619191,62134670.78,6900000,7072500
1063,2023,The Boogeyman,67307243,0.025,68989924.08,43244282,44325389.05,24062961,24664535.03
1064,2023,Frozen 2023 Re-release (Sing -A-Long),62846398,0.025,64417557.95,0,0,62846398,64417557.95
1065,2023,65,60730568,0.025,62248832.2,32062904,32864476.6,28667664,29384355.6
1066,2023,Magic Mike's Last Dance,57105156,0.025,58532784.9,26005156,26655284.9,31100000,31877500
1067,2023,Demon Slayer: Kimetsu No Yaiba - To the Swordsmith Village,56319351,0.025,57727334.78,10117806,10370751.15,46201545,47356583.63
1068,2023,The Boys in the Boat,55401397,0.025,56786431.93,52641306,53957338.65,2760091,2829093.275
1069,2023,Knock at the Cabin,54760947,0.025,56129970.68,35397980,36282929.5,19362967,19847041.18
1070,2023,Mummies,54475970,0.025,55837869.25,4275970,4382869.25,50200000,51455000
1071,2023,Jesus Revolution,54295801,0.025,55653196.03,52102987,53405561.68,2192814,2247634.35
1072,2023,Asteroid City,53857743,0.025,55204186.58,28153025,28856850.63,25704718,26347335.95
1073,2023,Spy x Family Code: White,51366942,0.025,52651115.55,4875000,4996875,46491942,47654240.55
1074,2023,One Life,49259272,0.025,50490753.8,5501974,5639523.35,43757298,44851230.45
1075,2023,Operation Fortune: Ruse de Guerre,48983306,0.025,50207888.65,6496125,6658528.125,42487181,43549360.53
1076,2023,Missing,48767848,0.025,49987044.2,32502025,33314575.63,16265823,16672468.58
1077,2023,Thanksgiving,46553280,0.025,47717112,31908884,32706606.1,14644396,15010505.9
1078,2023,Asterix & Obelix: The Middle Kingdom,46497678,0.025,47660119.95,0,0,46497678,47660119.95
1079,2023,Ruby Gillman: Teenage Kraken,45528749,0.025,46666967.73,15753600,16147440,29775149,30519527.73
1080,2023,The Holdovers,44333964,0.025,45442313.1,20355375,20864259.38,23978589,24578053.73
1081,2023,The Iron Claw,44257721,0.025,45364164.03,35070296,35947053.4,9187425,9417110.625
1082,2023,The Zone of Interest,44188272,0.025,45292978.8,8576457,8790868.425,35611815,36502110.38
1083,2023,There's Still Tomorrow,44064212,0.025,45165817.3,0,0,44064212,45165817.3
1084,2023,Renaissance: A Film by Beyoncé,43989684,0.025,45089426.1,33889684,34736926.1,10100000,10352500
1085,2023,Son of a Rich 2,42665169,0.025,43731798.23,0,0,42665169,43731798.23
1086,2023,Ferrari,42285029,0.025,43342154.73,18550028,19013778.7,23735001,24328376.03
1087,2023,80 for Brady,40362938,0.025,41372011.45,39330588,40313852.7,1032350,1058158.75
1088,2023,"Miraculous: Ladybug & Cat Noir, the Movie",40144153,0.025,41147756.83,0,0,40144153,41147756.83
1089,2023,My Big Fat Greek Wedding 3,38831076,0.025,39801852.9,28496030,29208430.75,10335046,10593422.15
1090,2023,Past Lives,38731919,0.025,39700216.98,11185625,11465265.63,27546294,28234951.35
1091,2023,The Expendables 4,37917985,0.025,38865934.63,16710153,17127906.83,21207832,21738027.8
1092,2023,Doraemon the Movie: Nobita's Sky Utopia,37475850,0.025,38412746.25,0,0,37475850,38412746.25
1093,2023,Smugglers,36851831,0.025,37773126.78,0,0,36851831,37773126.78
1094,2023,Kingdom 3,36259522,0.025,37166010.05,0,0,36259522,37166010.05
1095,2023,Ride On,36258730,0.025,37165198.25,128950,132173.75,36129780,37033024.5
1096,2023,Strays,36071267,0.025,36973048.68,23988885,24588607.13,12082382,12384441.55
1097,2023,Anatomy of a Fall,35521028,0.025,36409053.7,5076369,5203278.225,30444659,31205775.48
1098,2023,Noryang: Deadly Sea,34210966,0.025,35066240.15,315245,323126.125,33895721,34743114.03
1099,2023,Alibi.com 2,34114308,0.025,34967165.7,0,0,34114308,34967165.7
1100,2023,The Bremen Town Musicians,33213873,0.025,34044219.83,0,0,33213873,34044219.83
1101,2023,Priscilla,32957098,0.025,33781025.45,20960939,21484962.48,11996159,12296062.98
1102,2023,Don't Call it Mystery: The Movie,32488540,0.025,33300753.5,0,0,32488540,33300753.5
1103,2023,The Three Musketeers - Part I: D'Artagnan,31842992,0.025,32639066.8,0,0,31842992,32639066.8
1104,2023,Tokyo MER,30239900,0.025,30995897.5,0,0,30239900,30995897.5
1105,2023,Interstellar 2023 Re-release,30093495,0.025,30845832.38,0,0,30093495,30845832.38
1106,2023,Concrete Utopia,30077476,0.025,30829412.9,0,0,30077476,30829412.9
1107,2023,BTS: Yet to Come in Cinemas,29291883,0.025,30024180.08,8093270,8295601.75,21198613,21728578.33
1108,2023,Book Club: The Next Chapter,29014500,0.025,29739862.5,17581565,18021104.13,11432935,11718758.38
1109,2023,I Wish I Could Meet You Again on the Hill Where That Flower Blooms (2023),28933626,0.025,29656966.65,0,0,28933626,29656966.65
1110,2023,Jawan,28499044,0.025,29211520.1,15198530,15578493.25,13300514,13633026.85
1111,2023,The Wish of the Fairy Fish,28218581,0.025,28924045.53,0,0,28218581,28924045.53
1112,2023,Toy Story 2023 Re-release,27503758,0.025,28191351.95,0,0,27503758,28191351.95
1113,2023,Renfield,26493921,0.025,27156269.03,17297895,17730342.38,9196026,9425926.65
1114,2023,Gravity 2023 Re-release (10th Anniversary),24981634,0.025,25606174.85,0,0,24981634,25606174.85
1115,2023,Shin Jigen! Crayon Shin-chan the Movie,23839864,0.025,24435860.6,0,0,23839864,24435860.6
1116,2023,Perfect Days,23775811,0.025,24370206.28,3576392,3665801.8,20199419,20704404.48
1117,2023,The Challenge,23255724,0.025,23837117.1,0,0,23255724,23837117.1
1118,2023,American Fiction,22483370,0.025,23045454.25,21098470,21625931.75,1384900,1419522.5
1119,2023,The Last Voyage of the Demeter,21786275,0.025,22330931.88,13637180,13978109.5,8149095,8352822.375
1120,2023,The Three Musketeers - Part II: Milady,21691618,0.025,22233908.45,0,0,21691618,22233908.45
1121,2023,Guy Ritchie's the Covenant,21632392,0.025,22173201.8,16938039,17361489.98,4694353,4811711.825
1122,2023,"Are You There God? It's Me, Margaret.",21464043,0.025,22000644.08,20372406,20881716.15,1091637,1118927.925
1123,2023,Radical,21356027,0.025,21889927.68,8702731,8920299.275,12653296,12969628.4
1124,2023,Saltburn,21026167,0.025,21551821.18,11425829,11711474.73,9600338,9840346.45
1125,2023,Dumb Money,20703794,0.025,21221388.85,13925356,14273489.9,6761614,6930654.35
1126,2023,My Happy Marriage,19506407,0.025,19994067.18,0,0,19506407,19994067.18
1127,2023,The House of No Man,19490980,0.025,19978254.5,0,0,19490980,19978254.5
1128,2023,All of Us Strangers,19483770,0.025,19970864.25,4050103,4151355.575,15433667,15819508.68
1129,2023,Champions,19159065,0.025,19638041.63,16397335,16807268.38,2761730,2830773.25
1130,2023,Retribution,18685751,0.025,19152894.78,6937696,7111138.4,11748055,12041756.38
1131,2023,Next Goal Wins,18648802,0.025,19115022.05,6713826,6881671.65,11934976,12233350.4
1132,2023,IDOLiSH7 Movie: LIVE 4bit - BEYOND THE PERiOD,18638991,0.025,19104965.78,0,0,18638991,19104965.78
1133,2023,Love Reset,18425255,0.025,18885886.38,0,0,18425255,18885886.38
1134,2023,The Blackening,18169453,0.025,18623689.33,17707207,18149887.18,462246,473802.15
1135,2023,About My Father,18167819,0.025,18622014.48,12089391,12391625.78,6078428,6230388.7
1136,2023,Mavka: The Forest Song,17896788,0.025,18344207.7,0,0,17896788,18344207.7
1137,2023,The Birth of Kitaro: Mystery of GeGeGe,17842454,0.025,18288515.35,0,0,17842454,18288515.35
1138,2023,The Blind,17265487,0.025,17697124.18,17265487,17697124.18,0,0
1139,2023,Tokyo Revengers 2: Bloody Halloween - Destiny,17216567,0.025,17646981.18,0,0,17216567,17646981.18
1140,2023,Hypnotic,16281937,0.025,16688985.43,4500169,4612673.225,11781768,12076312.2
1141,2023,The Legend & Butterfly,16087771,0.025,16489965.28,0,0,16087771,16489965.28
1142,2023,Die drei ??? - Erbe des Drachen,15860016,0.025,16256516.4,0,0,15860016,16256516.4
1143,2023,Shin Kamen Rider,15835414,0.025,16231299.35,0,0,15835414,16231299.35
1144,2023,Joy Ride,15787674,0.025,16182365.85,12897789,13220233.73,2889885,2962132.125
1145,2023,Dunki,15473051,0.025,15859877.28,7460159,7646662.975,8012892,8213214.3
1146,2023,Tonde Saitama: Biwako Yori Ai o Komete,15107891,0.025,15485588.28,0,0,15107891,15485588.28
1147,2023,Only 3 Days Left,14985705,0.025,15360347.63,0,0,14985705,15360347.63
1148,2023,Open Season,14961612,0.025,15335652.3,0,0,14961612,15335652.3
1149,2023,A Guilty Conscience,14914575,0.025,15287439.38,0,0,14914575,15287439.38
1150,2023,Epic Tails,14854710,0.025,15226077.75,355088,363965.2,14499622,14862112.55
1151,2023,Tokyo Revengers 2: Bloody Halloween - Decisive Battle,14584970,0.025,14949594.25,0,0,14584970,14949594.25
1152,2023,Dr. Cheon and Lost Talisman,14574445,0.025,14938806.13,84362,86471.05,14490083,14852335.08
1153,2023,Sisu,14281199,0.025,14638228.98,7265622,7447262.55,7015577,7190966.425
1154,2023,Rehragout-Rendezvous,14127069,0.025,14480245.73,0,0,14127069,14480245.73
1155,2023,Ocho apellidos marroquís,13911064,0.025,14258840.6,0,0,13911064,14258840.6
1156,2023,His Only Son,13817186,0.025,14162615.65,12392740,12702558.5,1424446,1460057.15
1157,2023,Jeanne du Barry,13632476,0.025,13973287.9,0,0,13632476,13973287.9
1158,2023,The Point Men,13433834,0.025,13769679.85,0,0,13433834,13769679.85
1159,2023,"Manta, Manta: Legacy",13078126,0.025,13405079.15,0,0,13078126,13405079.15
1160,2023,Bottoms,12966048,0.025,13290199.2,12036071,12336972.78,929977,953226.425
1161,2023,Championext,12877645,0.025,13199586.13,0,0,12877645,13199586.13
1162,2023,Love Again,12696584,0.025,13013998.6,6230837,6386607.925,6465747,6627390.675
1163,2023,Three heroes and the Navel of the Earth,12612103,0.025,12927405.58,0,0,12612103,12927405.58
1164,2023,The Shift,12227761,0.025,12533455.03,12118219,12421174.48,109542,112280.55
1165,2023,Salaar,11958548,0.025,12257511.7,8929282,9152514.05,3029266,3104997.65
1166,2023,Beau Is Afraid,11955354,0.025,12254237.85,8176562,8380976.05,3778792,3873261.8
1167,2023,After Death,11794504,0.025,12089366.6,11478326,11765284.15,316178,324082.45
1168,2023,Tiger 3,11713932,0.025,12006780.3,5365263,5499394.575,6348669,6507385.725
1169,2023,Face Off 6: The Ticket of Destiny,11538081,0.025,11826533.03,0,0,11538081,11826533.03
1170,2023,Dream Scenario,11313697,0.025,11596539.43,5742193,5885747.825,5571504,5710791.6
1171,2023,Jungle Bunch: Operation Meltdown,11304419,0.025,11587029.48,831200,851980,10473219,10735049.48
1172,2023,Silent Night,11067228,0.025,11343908.7,8012103,8212405.575,3055125,3131503.125
1173,2023,What's Love Got to Do with It?,11065050,0.025,11341676.25,0,0,11065050,11341676.25
1174,2023,Sleep,10967729,0.025,11241922.23,0,0,10967729,11241922.23
1175,2023,Samurai Beyond Admiration Record to the World's Best,10876188,0.025,11148092.7,0,0,10876188,11148092.7
1176,2023,Honey Sweet,10765835,0.025,11034980.88,0,0,10765835,11034980.88
1177,2023,The Machine,10664328,0.025,10930936.2,10458331,10719789.28,205997,211146.925
1178,2023,After Everything,10644463,0.025,10910574.58,0,0,10644463,10910574.58
1179,2023,The Nightmare Before Christmas 30th Anniversary Re-Release,10431631,0.025,10692421.78,10251956,10508254.9,179675,184166.875
1180,2023,The Crime Is Mine,10370347,0.025,10629605.68,108949,111672.725,10261398,10517932.95
1181,2023,Les Segpa au ski,10203901,0.025,10458998.53,0,0,10203901,10458998.53
1182,2023,Freelance,10183118,0.025,10437695.95,5314136,5446989.4,4868982,4990706.55
1183,2023,Sun and Concrete,10119958,0.025,10372956.95,0,0,10119958,10372956.95
1184,2023,The Peasants,9930511,0.025,10178773.78,154423,158283.575,9776088,10020490.2
1185,2023,The Lord of the Rings: The Return of the King 2023 Re-release (20th Anniversary),9736432,0.025,9979842.8,1176085,1205487.125,8560347,8774355.675
1186,2023,The Great Escaper,9734770,0.025,9978139.25,0,0,9734770,9978139.25
1187,2023,Talk to Her Undated France Release,9550733,0.025,9789501.325,0,0,9549770,9788514.25
1188,2023,Rafadan Tayfa 4: Hayrimatör,9546067,0.025,9784718.675,0,0,9546067,9784718.675
1189,2023,The Braid,9408857,0.025,9644078.425,0,0,9408857,9644078.425
1190,2023,Kandahar,9387311,0.025,9621993.775,4813132,4933460.3,4574179,4688533.475
1191,2023,House Party,9285747,0.025,9517890.675,9002247,9227303.175,283500,290587.5
1192,2023,All Your Faces,9056053,0.025,9282454.325,0,0,9056053,9282454.325
1193,2023,The Animal Kingdom,8938787,0.025,9162256.675,11767,12061.175,8927020,9150195.5
1194,2023,The Wandering Earth II,8854786,0.025,9076155.65,5023132,5148710.3,3831654,3927445.35
1195,2023,Cats in the Museum,8771514,0.025,8990801.85,0,0,8771514,8990801.85
1196,2023,Father & Soldier,8598322,0.025,8813280.05,0,0,8598322,8813280.05
1197,2023,PreCure All Stars F,8519569,0.025,8732558.225,0,0,8519569,8732558.225
1198,2023,Dream,8317251,0.025,8525182.275,0,0,8317251,8525182.275
1199,2023,Vacaciones de verano,8209854,0.025,8415100.35,0,0,8209854,8415100.35
1200,2023,On the Wandering Paths,8185559,0.025,8390197.975,0,0,8185559,8390197.975
1201,2023,Weekend Rebels,8184539,0.025,8389152.475,0,0,8184539,8389152.475
1202,2024,Dune: Part Two,695792913,0,695792913,276592913,276592913,419200000,419200000
1203,2024,Godzilla x Kong: The New Empire,485216510,0,485216510,171616510,171616510,313600000,313600000
1204,2024,Kung Fu Panda 4,480306475,0,480306475,179982475,179982475,300324000,300324000
1205,2024,Bob Marley: One Love,177138001,0,177138001,96838001,96838001,80300000,80300000
1206,2024,Ghostbusters: Frozen Empire,176114270,0,176114270,102914270,102914270,73200000,73200000
1207,2024,The Beekeeper,152720535,0,152720535,66220535,66220535,86500000,86500000
1208,2024,Mean Girls,104404248,0,104404248,72404248,72404248,32000000,32000000
1209,2024,Madame Web,100280337,0,100280337,43817106,43817106,56463231,56463231
1210,2024,Argylle,95500586,0,95500586,45207275,45207275,50293311,50293311
1211,2024,Exhuma,92918534,0,92918534,2004702,2004702,90913832,90913832
1212,2024,Haikyuu!! The Dumpster Battle,62663242,0,62663242,0,0,62663242,62663242
1213,2024,Night Swim,54075969,0,54075969,32494740,32494740,21581229,21581229
1214,2024,Civil War,49464260,0,49464260,44884414,44884414,4579846,4579846
1215,2024,The First Omen,45065038,0,45065038,17765038,17765038,27300000,27300000
1216,2024,Demon Slayer: Kimetsu No Yaiba - To the Hashira Training,44301018,0,44301018,17657658,17657658,26643360,26643360
1217,2024,Imaginary,38940844,0,38940844,27962041,27962041,10978803,10978803
1218,2024,Arthur the King,30206554,0,30206554,24453828,24453828,5752726,5752726
1219,2024,Mobile Suit Gundam Seed Freedom,29073426,0,29073426,0,0,29073426,29073426
1220,2024,Monkey Man,28309790,0,28309790,21674790,21674790,6635000,6635000
1221,2024,The Master and Margarita,26130163,0,26130163,0,0,26130163,26130163
1222,2024,A Strange House,25181533,0,25181533,0,0,25181533,25181533
1223,2024,Doraemon the Movie: Nobita's Earth Symphony,24956303,0,24956303,0,0,24956303,24956303
1224,2024,Mai,22066339,0,22066339,0,0,22066339,22066339
1225,2024,Detective Conan: The Million-Dollar Pentagram,21867208,0,21867208,0,0,21867208,21867208
1226,2024,Immaculate,21670138,0,21670138,15580724,15580724,6089414,6089414
1227,2024,Autumn and the Black Jaguar,21320076,0,21320076,0,0,21320076,21320076
1228,2024,Wicked Little Letters,21062717,0,21062717,3589878,3589878,17472839,17472839
1229,2024,Lyod 3,20641464,0,20641464,0,0,20641464,20641464
1230,2024,Cabrini,20050484,0,20050484,19307447,19307447,743037,743037
1231,2024,Ordinary Angels,19447276,0,19447276,19174421,19174421,272855,272855
1232,2024,Golden Kamuy,19077748,0,19077748,0,0,19077748,19077748
1233,2024,Chantal in Fairyland,18695030,0,18695030,0,0,18695030,18695030
1234,2024,Cocorico,17205279,0,17205279,0,0,17205279,17205279
1235,2024,Kleks Academy,15348026,0,15348026,0,0,15348026,15348026
1236,2024,Abigail,15227000,0,15227000,10200000,10200000,5027000,5027000
1237,2024,The Chosen: S4 Episodes 1-3,14799620,0,14799620,14409169,14409169,390451,390451
1238,2024,Citizen of a Kind,12494455,0,12494455,0,0,12494455,12494455
1239,2024,Maison de retraite 2,11196943,0,11196943,0,0,11196943,11196943
1240,2024,Eine Million Minuten,11077140,0,11077140,0,0,11077140,11077140
1241,2024,Article 370,11073822,0,11073822,980649,980649,10093173,10093173
1242,2024,Alienoid: The Return to the Future,10693858,0,10693858,60720,60720,10633138,10633138
1243,2024,Cat and Dog,10624609,0,10624609,0,0,10624609,10624609
1244,2024,Late Night with the Devil,10368490,0,10368490,9516208,9516208,852282,852282
1245,2024,Letuchiy korabl,10054895,0,10054895,0,0,10054895,10054895
1246,2024,Lisa Frankenstein,9927714,0,9927714,9774285,9774285,153429,153429
1247,2024,The Chosen: S4 Episodes 4-6,9482744,0,9482744,9482744,9482744,0,0
1248,2024,The Ministry of Ungentlemanly Warfare,9000000,0,9000000,9000000,9000000,0,0
1249,2024,Lohusa,8746751,0,8746751,0,0,8746751,8746751
1250,2024,Love Lies Bleeding,8568141,0,8568141,7830385,7830385,737756,737756
1251,2024,Onegin,8369548,0,8369548,0,0,8369548,8369548
1252,2024,The Birth of Korea,8050507,0,8050507,0,0,8050507,8050507
1253,2024,The Chosen: S4 Episodes 7-8,7729152,0,7729152,7729152,7729152,0,0
1254,2024,Back to Black,7470502,0,7470502,0,0,7470502,7470502
1255,2024,Kolpaçino 4 4'lük,7445372,0,7445372,0,0,7445372,7445372
1256,2024,Yolo,6841019,0,6841019,2000394,2000394,4840625,4840625
1257,2024,Drive-Away Dolls,6742839,0,6742839,5028215,5028215,1714624,1714624
1258,2024,I.S.S.,6573799,0,6573799,6573799,6573799,0,0
1259,2024,Land of Bad,6525125,0,6525125,4620045,4620045,1905080,1905080
1260,2024,Baghead,6423243,0,6423243,0,0,6423243,6423243
1261,2024,Troll Factory,6281347,0,6281347,0,0,6281347,6281347
1262,2024,"April, Come She Will",6194463,0,6194463,0,0,6194463,6194463
1263,2024,The Book of Clarence,6132813,0,6132813,6132813,6132813,0,0
1264,2024,Un mondo a parte,5789874,0,5789874,0,0,5789874,5789874
1265,2024,SUGA: Agust D Tour 'D-DAY' the Movie,5785163,0,5785163,1951896,1951896,3833267,3833267
1266,2024,Air,5468936,0,5468936,0,0,5468936,5468936
1267,2024,Matching,5348492,0,5348492,0,0,5348492,5348492
1268,2024,Force of Nature: The Dry 2,5186379,0,5186379,0,0,5186379,5186379
1269,2024,Someone Like You,5182469,0,5182469,5182469,5182469,0,0
1270,2024,The Goat Life,5001990,0,5001990,625000,625000,4376990,4376990
1271,2024,Table for Six 2,4871447,0,4871447,0,0,4871447,4871447
1272,2024,Anweshippin Kandethum,4459155,0,4459155,0,0,4459155,4459155
1273,2024,Sami Swoi. Poczatek,4433525,0,4433525,0,0,4433525,4433525
1274,2024,El Roomie,4418253,0,4418253,0,0,4418253,4418253
1275,2024,No Way Up,4273662,0,4273662,148582,148582,4125080,4125080
1276,2024,I soliti idioti 3: Il ritorno,4174340,0,4174340,0,0,4174340,4174340
1277,2024,Dune 2024 Re-release,3995610,0,3995610,0,0,3995610,3995610
1278,2024,Fighter,3800771,0,3800771,1000000,1000000,2800771,2800771
1279,2024,Manjummel Boys,3782608,0,3782608,0,0,3782608,3782608
1280,2024,Gap Lai Chi Bau,3749297,0,3749297,0,0,3749297,3749297
1281,2024,Crew,3734407,0,3734407,1500000,1500000,2234407,2234407
1282,2024,Daaaaaali!,3685956,0,3685956,0,0,3685956,3685956
1283,2024,La familia Benetón,3659678,0,3659678,0,0,3659678,3659678
1284,2024,Breaking Point,3532131,0,3532131,0,0,3532131,3532131
1285,2024,The Moon Thieves,3522654,0,3522654,0,0,3522654,3522654
1286,2024,3391 Kilometres,3506051,0,3506051,0,0,3506051,3506051
1287,2024,Peppa's Cinema Party,3473576,0,3473576,0,0,3473576,3473576
1288,2024,Pare parecchio Parigi,3445925,0,3445925,0,0,3445925,3445925
1289,2024,Konets Slavy,3387736,0,3387736,0,0,3387736,3387736
1290,2024,Lovesick Ellie,3365139,0,3365139,0,0,3365139,3365139
1291,2024,"Baby boom, or Eggnog 5",3236512,0,3236512,0,0,3236512,3236512
1292,2024,Lucky Winners,3184504,0,3184504,0,0,3184504,3184504
1293,2024,2024 Oscar Nominated Short Films: Documentary,3162293,0,3162293,3162293,3162293,0,0
1294,2024,Boléro,3106182,0,3106182,0,0,3106182,3106182
1295,2024,Verliefd op Bali,3069304,0,3069304,0,0,3069304,3069304
1296,2024,Budda. Dzieciak '98,2983610,0,2983610,0,0,2983610,2983610
1297,2024,Shrek 2 2024 Re-release,2961170,0,2961170,2961170,2961170,0,0
1298,2024,Maria Montessori,2817198,0,2817198,0,0,2817198,2817198
1299,2024,Kensuke's Kingdom,2806933,0,2806933,0,0,2806933,2806933
1300,2024,Silent Love,2739320,0,2739320,0,0,2739320,2739320
1301,2024,Rob N Roll,2739036,0,2739036,0,0,2739036,2739036
1302,2024,Noche De Bodas,2734739,0,2734739,0,0,2734739,2734739
1303,2024,Detective Conan vs. Kid the Phantom Thief,2712761,0,2712761,0,0,2712761,2712761
1304,2024,All the Long Nights,2689624,0,2689624,0,0,2689624,2689624
1305,2024,Dog Days,2658318,0,2658318,0,0,2658318,2658318
1306,2024,Operation Portugal 2 - La vie de chateau,2569068,0,2569068,0,0,2569068,2569068
1307,2024,Queen Rock Montreal,2537304,0,2537304,2000000,2000000,537304,537304
1308,2024,Ducobu passe au vert!,2522436,0,2522436,0,0,2522436,2522436
1309,2024,We 12,2491117,0,2491117,0,0,2491117,2491117
1310,2024,The American Society of Magical Negroes,2480645,0,2480645,2480645,2480645,0,0
1311,2024,Too Old for Fairy Tales 2,2462639,0,2462639,0,0,2462639,2462639
1312,2024,Coppers,2462266,0,2462266,0,0,2462266,2462266
1313,2024,50 km/h,2448552,0,2448552,0,0,2448552,2448552
1314,2024,Kral Sakir: Devler Uyandi,2443753,0,2443753,0,0,2443753,2443753
1315,2024,National Theatre Live: Vanya,2436456,0,2436456,0,0,2436456,2436456
1316,2024,Noah's Ark,2433322,0,2433322,0,0,2433322,2433322
1317,2024,14 jours pour aller mieux,2357682,0,2357682,0,0,2357682,2357682
1318,2024,Premalu,2342985,0,2342985,0,0,2342985,2342985
1319,2024,The Good Teacher,2340886,0,2340886,0,0,2340886,2340886
1320,2024,Tati Part Time,2330252,0,2330252,0,0,2330252,2330252
1321,2024,The Long Game,2330198,0,2330198,2330198,2330198,0,0
1322,2024,White Bird,2326201,0,2326201,0,0,2326201,2326201
1323,2024,Bonnard: Pierre & Marthe,2311172,0,2311172,0,0,2311172,2311172
1324,2024,Atatürk 1881 - 1919 Film 2 Release,2287455,0,2287455,0,0,2287455,2287455
1325,2024,Picnic,2256981,0,2256981,0,0,2256981,2256981
1326,2024,Tillu Square,2246363,0,2246363,1870000,1870000,376363,376363
1327,2024,It's Raining Men,2205080,0,2205080,0,0,2205080,2205080
1328,2024,Don't Lose Your Head!,2113320,0,2113320,0,0,2113320,2113320
1329,2024,Todas menos tú,2110306,0,2110306,0,0,2110306,2110306
1330,2024,The Ark and the Darkness,2097560,0,2097560,2097560,2097560,0,0
1331,2024,Bade Miyan Chote Miyan,2081617,0,2081617,689505,689505,1392112,1392112
1332,2024,Race for Glory: Audi vs. Lancia,2055504,0,2055504,0,0,2055504,2055504
1333,2024,Aristokratka ve varu,2035808,0,2035808,0,0,2035808,2035808
1334,2024,Out of Darkness,1987281,0,1987281,1951547,1951547,35734,35734
1335,2024,Nedelja,1905017,0,1905017,0,0,1905017,1905017
1336,2024,Salle des profs,1855403,0,1855403,0,0,1855403,1855403
1337,2024,YA - medved,1842294,0,1842294,0,0,1842294,1842294
1338,2024,Un altro Ferragosto,1816797,0,1816797,0,0,1816797,1816797
1339,2024,Love You as the World Ends: Episode #4.5,1814466,0,1814466,0,0,1814466,1814466
1340,2024,Komandir,1808588,0,1808588,0,0,1808588,1808588
1341,2024,Valle de sombras,1805813,0,1805813,0,0,1805813,1805813
1342,2024,Homeward,1779693,0,1779693,0,0,1779693,1779693
1343,2024,Aavesham,1760041,0,1760041,0,0,1760041,1760041
1344,2024,Adam & Eve,1754266,0,1754266,0,0,1754266,1754266
1345,2024,El correo,1748642,0,1748642,0,0,1748642,1748642
1346,2024,Kardes Takimi,1748615,0,1748615,0,0,1748615,1748615
1347,2024,La ferme des Bertrand,1719910,0,1719910,0,0,1719910,1719910
1348,2024,Teri Baaton Mein Aisa Uljha Jiya,1699722,0,1699722,0,0,1699722,1699722
1349,2024,Dead Man,1689878,0,1689878,0,0,1689878,1689878
1350,2024,Like a Prince,1681549,0,1681549,0,0,1681549,1681549
1351,2024,Madame de Sévigné,1640410,0,1640410,0,0,1640410,1640410
1352,2024,I Did It My Way,1628896,0,1628896,198405,198405,1430491,1430491
1353,2024,A Silence,1562685,0,1562685,0,0,1562685,1562685
1354,2024,Romeo è Giulietta,1555180,0,1555180,0,0,1555180,1555180
1355,2024,Dune IMAX,1550188,0,1550188,570000,570000,980188,980188
1356,2024,Mothers' Instinct,1549176,0,1549176,0,0,1549176,1549176
1357,2024,Let's Go Karaoke!,1510372,0,1510372,0,0,1510372,1510372
1358,2024,Shaitaan,1501788,0,1501788,0,0,1501788,1501788
1359,2024,National Theatre Live: Dear England,1485050,0,1485050,0,0,1485050,1485050
1360,2024,Off-Season,1481675,0,1481675,0,0,1481675,1481675
1361,2024,Matka v trapu,1477538,0,1477538,0,0,1477538,1477538
1362,2024,The Promised Land,1468092,0,1468092,257749,257749,1210343,1210343
1363,2024,Et plus si affinités,1455065,0,1455065,0,0,1455065,1455065
1364,2024,Miller's Girl,1430080,0,1430080,0,0,1430080,1430080
1365,2024,Karaoké,1404406,0,1404406,0,0,1404406,1404406
1366,2024,Pozyvnoy «Passazhir»,1401216,0,1401216,0,0,1401216,1401216
1367,2024,Irklais per Atlanta,1391337,0,1391337,0,0,1391337,1391337
1368,2024,Bramayugam,1388375,0,1388375,0,0,1388375,1388375
1369,2024,Varshangalkku Shesham,1386760,0,1386760,0,0,1386760,1386760
1370,2024,White Courage,1373237,0,1373237,0,0,1373237,1373237
1371,2024,Les chèvres!,1317742,0,1317742,0,0,1317742,1317742
1372,2024,National Theatre Live: The Motive and the Cue,1305869,0,1305869,0,0,1305869,1305869
1373,2024,Firebrand,1303716,0,1303716,0,0,1303716,1303716
1374,2024,Neon Genesis Evangelion: The End of Evangelion,1302300,0,1302300,1302300,1302300,0,0
1375,2024,Sladky zivot,1275062,0,1275062,0,0,1275062,1275062
1376,2024,A Nice Jewish Boy,1267653,0,1267653,0,0,1267653,1267653
1377,2024,Making Of,1261221,0,1261221,0,0,1261221,1261221
1378,2024,Color of Victory,1260020,0,1260020,0,0,1260020,1260020
1379,2024,Enea,1241570,0,1241570,0,0,1241570,1241570
1380,2024,Unknown Title,1222901,0,1222901,0,0,1222901,1222901
1381,2024,18×2 Beyond Youthful Days,1205020,0,1205020,0,0,1205020,1205020
1382,2024,Sleeping Dogs,1197601,0,1197601,0,0,1197601,1197601
1383,2024,Meet the Leroys,1177743,0,1177743,0,0,1177743,1177743
1384,2024,Dieci minuti,1147973,0,1147973,0,0,1147973,1147973
1385,2024,Políticamente incorrectos,1142279,0,1142279,0,0,1142279,1142279
1386,2024,This is My Mother,1113611,0,1113611,0,0,1113611,1113611
1387,2024,Vojna policajtov,1082774,0,1082774,0,0,1082774,1082774
1388,2024,Fuks 2,1078203,0,1078203,0,0,1078203,1078203
1389,2024,Ibelin,1076764,0,1076764,0,0,1076764,1076764
1390,2024,Operation Valentine,1076193,0,1076193,0,0,1076193,1076193
1391,2024,Beautiful Wedding,1069836,0,1069836,0,0,1069836,1069836
1392,2024,The Green Deal,1066078,0,1066078,0,0,1066078,1066078
1393,2024,Amelia's Children,1015828,0,1015828,11073,11073,1004755,1004755
1394,2024,Tainted Soul,1007804,0,1007804,0,0,1007804,1007804
1395,2024,Kos,995030,0,995030,0,0,995030,995030
1396,2024,Abraham Ozler,978538,0,978538,0,0,978538,978538
1397,2024,Now or Never!,974028,0,974028,0,0,974028,974028
1398,2024,Milosc jak miód,959551,0,959551,0,0,959551,959551
1399,2024,Cem Karaca'nin Gözyaslari,957421,0,957421,0,0,957421,957421
1400,2024,Victoria må dø,953884,0,953884,0,0,953884,953884
1401,2024,The Glory of Life,947881,0,947881,0,0,947881,947881